Details,Posting Date,Description,Amount,Type,Balance
DEBIT,2/3/2021,POS DEBIT                WHOLEFDS SCT 102          PHOENIX      AZ,-59.61,MISC_DEBIT, 
DEBIT,2/3/2021,POS DEBIT                WHOLEFDS SCT 102          PHOENIX      AZ,-13.08,MISC_DEBIT, 
DEBIT,2/3/2021,POS DEBIT                WHOLEFDS SCT 102         PHOENIX       AZ,-14.95,MISC_DEBIT, 
DEBIT,2/2/2021,SQ *PRESS SCOTTSDALE QU Scottsdale AZ        02/01,-6.94,DEBIT_CARD,1610.98
DEBIT,2/1/2021,GOOGLE *YouTube Music 855-836-3987 CA        01/30,-10.85,DEBIT_CARD,1617.92
DEBIT,2/1/2021,DISCOVER         E-PAYMENT  2463            WEB ID: 2510020270,-453.31,ACH_DEBIT,1628.77
DEBIT,2/1/2021,FID BKG SVC LLC  MONEYLINE                  PPD ID: 0368004600,-1000,ACH_DEBIT,2082.08
DEBIT,2/1/2021,GABLES-1JP20466  WEB PMTS   R78427          WEB ID: 9000326709,-1300,ACH_DEBIT,3082.08
DEBIT,2/1/2021,COSTCO GAS #0427 SCOTTSDALE AZ       076336  02/01,-38,DEBIT_CARD,4382.08
DEBIT,2/1/2021,SQ *PRESS SCOTTSDALE QU Scottsdale AZ        02/01,-5.24,DEBIT_CARD,4420.08
DEBIT,2/1/2021,WHOLEFDS SCT 10246 PHOENIX AZ                01/31,-29.49,DEBIT_CARD,4425.32
DEBIT,2/1/2021,THE HERB BOX SOUTHBRID SCOTTSDALE AZ         01/30,-63.49,DEBIT_CARD,4454.81
DEBIT,2/1/2021,WHOLEFDS SCT 10246 PHOENIX AZ                01/29,-45.62,DEBIT_CARD,4518.3
DEBIT,2/1/2021,PAYPAL *MEDIUM.COM 402-935-7733 CA           01/29,-5,DEBIT_CARD,4563.92
CREDIT,2/1/2021,Online Transfer from SAV ...9797 transaction#: 11093869250,455,ACCT_XFER,4568.92
DEBIT,1/29/2021,WHOLEFDS SCT 10246 PHOENIX AZ                01/28,-13.98,DEBIT_CARD,4113.92
CREDIT,1/29/2021,CVO HOLDING COMP DIRECT DEP                 PPD ID: 9111111101,2422.51,ACH_CREDIT,4127.9
DEBIT,1/28/2021,STAPLES 0715 SCOTTSDALE AZ           017590  01/28,-160.44,DEBIT_CARD,1705.39
DEBIT,1/28/2021,WHOLEFDS SCT 10246 PHOENIX AZ                01/27,-27.38,DEBIT_CARD,1865.83
DEBIT,1/27/2021,STARBUCKS STORE 62567 PHOENIX AZ             01/26,-2.99,DEBIT_CARD,1893.21
DEBIT,1/26/2021,WALGREENS STORE 20631 SCOTTSDALE AZ  110185  01/26,-15.11,DEBIT_CARD,1896.2
DEBIT,1/26/2021,ELEVATE COFFEE COMPANY PHOENIX AZ            01/25,-8.32,DEBIT_CARD,1911.31
DEBIT,1/25/2021,BEST BUY      00014811 PHOENIX AZ    948062  01/25,-217.19,DEBIT_CARD,1919.63
DEBIT,1/25/2021,WHOLEFDS SCT 10246 PHOENIX AZ                01/24,-5.99,DEBIT_CARD,2136.82
DEBIT,1/25/2021,WALGREENS STORE 20631 SCOTTSDALE AZ  432747  01/24,-6.47,DEBIT_CARD,2142.81
DEBIT,1/25/2021,CIRCLE K 05915 SCOTTSDALE AZ                 01/24,-13.53,DEBIT_CARD,2149.28
DEBIT,1/25/2021,ELEVATE COFFEE COMPANY PHOENIX AZ            01/23,-2.16,DEBIT_CARD,2162.81
DEBIT,1/25/2021,ELEVATE COFFEE COMPANY PHOENIX AZ            01/23,-4.28,DEBIT_CARD,2164.97
DEBIT,1/25/2021,WHOLEFDS SCT 10246 PHOENIX AZ                01/23,-50.51,DEBIT_CARD,2169.25
DEBIT,1/20/2021,APS electric pmt PAYMENT    3518057919      WEB ID: 1860011170,-58.52,ACH_DEBIT,2219.76
DEBIT,1/20/2021,GCU STUDENT UNION PHOENIX AZ                 01/19,-5.52,DEBIT_CARD,2278.28
DEBIT,1/19/2021,WHOLEFDS SCT 10246 PHOENIX AZ                01/18,-64.76,DEBIT_CARD,2283.8
DEBIT,1/19/2021,SQ *PRESS WATERFRONT Scottsdale AZ           01/17,-3.97,DEBIT_CARD,2348.56
DEBIT,1/19/2021,PF CHANGS #9978 SCOTTSDALE AZ                01/17,-25.07,DEBIT_CARD,2352.53
DEBIT,1/19/2021,MACY'S    7014 E CAMEL SCOTTSDALE AZ         01/17,-23.77,DEBIT_CARD,2377.6
DEBIT,1/19/2021,H&M0209 SCOTTSDALE AZ                318147  01/17,-32.21,DEBIT_CARD,2401.37
DEBIT,1/19/2021,TFK BILTMORE PHOENIX AZ                      01/16,-19.02,DEBIT_CARD,2433.58
DEBIT,1/19/2021,SHELL SERVICE STATION SCOTTSDALE AZ  048446  01/16,-20.01,DEBIT_CARD,2452.6
DEBIT,1/19/2021,WHOLEFDS SCT 10246 PHOENIX AZ                01/15,-24.9,DEBIT_CARD,2472.61
DEBIT,1/15/2021,VZWRLSS*APOCC VISN 800-922-0204 FL           01/15,-78.72,DEBIT_CARD,2497.51
DEBIT,1/15/2021,Online Transfer to SAV ...9797 transaction#: 11004913923 01/15,-1000,ACCT_XFER,2576.23
DEBIT,1/15/2021,Online Payment 11004879196 To ALA 5817 01/15,-432.61,LOAN_PMT,3576.23
DEBIT,1/15/2021,SAFEWAY #1253 SCOTTSDALE AZ                  01/14,-27.22,DEBIT_CARD,4008.84
DEBIT,1/15/2021,SCOTTSDALE EYE PHYSIC 480-994-1872 AZ        01/13,-136,DEBIT_CARD,4036.06
CREDIT,1/15/2021,CVO HOLDING COMP DIRECT DEP                 PPD ID: 9111111101,2447.72,ACH_CREDIT,4172.06
DEBIT,1/13/2021,GCU STUDENT UNION PHOENIX AZ                 01/12,-2.27,DEBIT_CARD,1724.34
DEBIT,1/13/2021,GCU STUDENT UNION PHOENIX AZ                 01/12,-2.44,DEBIT_CARD,1726.61
DEBIT,1/13/2021,GCU STUDENT UNION PHOENIX AZ                 01/12,-4.43,DEBIT_CARD,1729.05
DEBIT,1/12/2021,WHOLEFDS SCT 10246 PHOENIX AZ                01/11,-7.59,DEBIT_CARD,1733.48
DEBIT,1/11/2021,Amazon Prime*G37X26F Amzn.com/bill WA        01/08,-14.11,DEBIT_CARD,1741.07
DEBIT,1/11/2021,HLU*Hulu 16100496598 HULU.COM/BILL CA        01/10,-27.93,DEBIT_CARD,1755.18
DEBIT,1/11/2021,SOUTHWEST GAS    APP                        PPD ID: 4880085720,-36.19,ACH_DEBIT,1783.11
DEBIT,1/11/2021,TRADER JOE'S #087  QPS SCOTTSDALE AZ         01/10,-12.68,DEBIT_CARD,1819.3
DEBIT,1/11/2021,WHOLEFDS SCT 10246 PHOENIX AZ                01/08,-73.49,DEBIT_CARD,1831.98
DEBIT,1/11/2021,DOORDASH*SHAKE SHACK WWW.DOORDASH. CA        01/09,-34.35,DEBIT_CARD,1905.47
CREDIT,1/11/2021,VENMO            CASHOUT                    PPD ID: 5264681992,45,ACH_CREDIT,1939.82
DEBIT,1/8/2021,SPORT CLIPS - AZ126 SCOTTSDALE AZ            01/07,-29,DEBIT_CARD,1894.82
DEBIT,1/7/2021,WHOLEFDS SCT 10246 PHOENIX AZ                01/06,-20.37,DEBIT_CARD,1923.82
DEBIT,1/5/2021,COINBASE.COM     8889087930 2FBUKUXM2C37    WEB ID: 1455293997,-6,ACH_DEBIT,1944.19
DEBIT,1/5/2021,MATTRESS FIRM 029165 PHOENIX AZ              01/04,-2529.28,DEBIT_CARD,1950.19
CREDIT,1/5/2021,VENMO            CASHOUT                    PPD ID: 5264681992,47,ACH_CREDIT,4479.47
DEBIT,1/4/2021,HLU*Hulu 16100496563 HULU.COM/BILL CA        01/02,-3.86,DEBIT_CARD,4432.47
DEBIT,1/4/2021,FID BKG SVC LLC  MONEYLINE                  PPD ID: 0368004600,-1000,ACH_DEBIT,4436.33
DEBIT,1/4/2021,GABLES-1JP20466  WEB PMTS   H553Y6          WEB ID: 9000326709,-1300,ACH_DEBIT,5436.33
DEBIT,1/4/2021,WHOLEFDS SCT 10246 PHOENIX AZ                01/03,-14.97,DEBIT_CARD,6736.33
DEBIT,1/4/2021,FRY'S FOOD DRG 0673 SCOTTSDALE AZ            01/03,-94.21,DEBIT_CARD,6751.3
DEBIT,1/4/2021,PF CHANGS #5300 OLO 111-111-1111 AZ          01/03,-38.32,DEBIT_CARD,6845.51
DEBIT,1/4/2021,BEST BUY      00008706 SCOTTSDALE AZ 397462  01/02,-10.79,DEBIT_CARD,6883.83
DEBIT,1/4/2021,Online Transfer to SAV ...9797 transaction#: 10929175296 01/04,-400,ACCT_XFER,6894.62
DEBIT,1/4/2021,FRY'S FOOD DRG 120 SCOTTSDALE AZ             01/01,-18.09,DEBIT_CARD,7294.62
DEBIT,1/4/2021,CVS/PHARMACY #10529 SCOTTSDALE AZ            01/01,-16.82,DEBIT_CARD,7312.71
CREDIT,1/4/2021,IRS  TREAS 310   XXTAXEIP2                  PPD ID: 9111736069,600,ACH_CREDIT,7329.53
CREDIT,1/4/2021,Online Transfer from SAV ...9797 transaction#: 10941640606,2500,ACCT_XFER,6729.53
DEBIT,12/31/2020,GOOGLE *YouTube Music 855-836-3987 CA        12/30,-10.85,DEBIT_CARD,4229.53
DEBIT,12/31/2020,WHOLEFDS SCT 10246 PHOENIX AZ                12/30,-13.59,DEBIT_CARD,4240.38
DEBIT,12/31/2020,STORE MGRSBUX53805 TEMPE AZ                  12/30,-6,DEBIT_CARD,4253.97
CREDIT,12/31/2020,CVO HOLDING COMP DIRECT DEP                 PPD ID: 9111111101,2428.67,ACH_CREDIT,4259.97
DEBIT,12/30/2020,IKEA TEMPE TEMPE AZ                  987772  12/30,-151.32,DEBIT_CARD,1831.3
DEBIT,12/30/2020,SQ *PRESS SCOTTSDALE QU Phoenix AZ           12/29,-7.67,DEBIT_CARD,1982.62
DEBIT,12/29/2020,VENMO            PAYMENT    5002485036      WEB ID: 3264681992,-10,ACH_DEBIT,1990.29
DEBIT,12/29/2020,VENMO            PAYMENT    5002462345      WEB ID: 3264681992,-14,ACH_DEBIT,2000.29
DEBIT,12/29/2020,FRY'S FOOD DRG 120 SCOTTSDALE AZ             12/28,-61.96,DEBIT_CARD,2014.29
DEBIT,12/29/2020,WHOLEFDS SCT 10246 PHOENIX AZ                12/28,-13.28,DEBIT_CARD,2076.25
CREDIT,12/29/2020,VENMO            CASHOUT                    PPD ID: 5264681992,30,ACH_CREDIT,2089.53
DEBIT,12/28/2020,DISCOVER         E-PAYMENT  2463            WEB ID: 2510020270,-54.92,ACH_DEBIT,2059.53
DEBIT,12/28/2020,WHOLEFDS SCT 10246 PHOENIX AZ                12/27,-47.46,DEBIT_CARD,2114.45
DEBIT,12/28/2020,COSTCO GAS #0427 SCOTTSDALE AZ       014814  12/26,-31.98,DEBIT_CARD,2161.91
DSLIP,12/28/2020,REMOTE ONLINE DEPOSIT #          1,115,CHECK_DEPOSIT,2193.89
DEBIT,12/24/2020,SAFEWAY #1253 SCOTTSDALE AZ                  12/23,-53.49,DEBIT_CARD,2078.89
DEBIT,12/24/2020,WHOLEFDS SCT 10246 PHOENIX AZ                12/23,-44,DEBIT_CARD,2132.38
DEBIT,12/24/2020,Amazon.com*KS4O69FQ3 Amzn.com/bill WA        12/23,-141.17,DEBIT_CARD,2176.38
DEBIT,12/23/2020,SAFEWAY #1253 SCOTTSDALE AZ                  12/22,-91.89,DEBIT_CARD,2317.55
DEBIT,12/23/2020,WHOLEFDS SCT 10246 PHOENIX AZ                12/22,-38.63,DEBIT_CARD,2409.44
CREDIT,12/23/2020,VENMO            CASHOUT                    PPD ID: 5264681992,30,ACH_CREDIT,2448.07
CREDIT,12/23/2020,VENMO            CASHOUT                    PPD ID: 5264681992,62,ACH_CREDIT,2418.07
DEBIT,12/21/2020,WHOLEFDS SCT 10246 PHOENIX AZ                12/20,-29.72,DEBIT_CARD,2356.07
DEBIT,12/18/2020,Online Transfer to SAV ...9797 transaction#: 10838901435 12/18,-1000,ACCT_XFER,2385.79
DEBIT,12/18/2020,CVS/PHARMACY #09202 PHOENIX AZ               12/17,-23.85,DEBIT_CARD,3385.79
CREDIT,12/18/2020,CVO HOLDING COMP DIRECT DEP                 PPD ID: 9111111101,2470.05,ACH_CREDIT,3409.64
DEBIT,12/17/2020,AIRBNB  HMFKRTABCD AIRBNB.COM CA             12/17,231.56,DEBIT_CARD,939.59
DEBIT,12/16/2020,WHOLEFDS SCT 10246 PHOENIX AZ                12/15,-21.67,DEBIT_CARD,708.03
DEBIT,12/16/2020,PAYPAL *MEDIUM.COM 402-935-7733 CA           12/15,-5,DEBIT_CARD,729.7
DEBIT,12/15/2020,AIRBNB  HMFKRTABCD AIRBNB.COM CA             12/14,-416.72,DEBIT_CARD,734.7
DEBIT,12/14/2020,APS electric pmt PAYMENT    3518057919      WEB ID: 1860011170,-49.88,ACH_DEBIT,1151.42
DEBIT,12/14/2020,TST* STATE 48 LAGER HOU SCOTTSDALE AZ        12/13,-24.8,DEBIT_CARD,1201.3
DEBIT,12/14/2020,SAFEWAY #1253 SCOTTSDALE AZ                  12/12,-19.3,DEBIT_CARD,1226.1
DEBIT,12/14/2020,WHOLEFDS SCT 10246 PHOENIX AZ                12/12,-8.98,DEBIT_CARD,1245.4
DEBIT,12/14/2020,GUITAR CENTER MOTO #3 866-498-7882 MI        12/12,-40,DEBIT_CARD,1254.38
DEBIT,12/14/2020,ELEVATE COFFEE COMPANY PHOENIX AZ            12/12,-4.15,DEBIT_CARD,1294.38
DEBIT,12/14/2020,Prime Video*2E6BE2JV3 888-802-3080 WA        12/12,-4.33,DEBIT_CARD,1298.53
DEBIT,12/14/2020,WHOLEFDS SCT 10246 PHOENIX AZ                12/11,-27.36,DEBIT_CARD,1302.86
DEBIT,12/14/2020,CIRCLE K 05915 SCOTTSDALE AZ                 12/11,-25.11,DEBIT_CARD,1330.22
DEBIT,12/11/2020,WHOLEFDS SCT 10246 PHOENIX AZ                12/10,-4.08,DEBIT_CARD,1355.33
DEBIT,12/10/2020,HLU*Hulu 16100496577 HULU.COM/BILL CA        12/10,-12.94,DEBIT_CARD,1359.41
DEBIT,12/10/2020,WHOLEFDS SCT 10246 PHOENIX AZ                12/09,-10.37,DEBIT_CARD,1372.35
DEBIT,12/10/2020,AMZN Mktp US*PK1161L Amzn.com/bill WA        12/09,-28.23,DEBIT_CARD,1382.72
DEBIT,12/10/2020,AMZN Mktp US*NK69F8D Amzn.com/bill WA        12/09,-33.65,DEBIT_CARD,1410.95
DEBIT,12/9/2020,Amazon Prime*7E4ZB8T Amzn.com/bill WA        12/08,-14.11,DEBIT_CARD,1444.6
DEBIT,12/9/2020,SOUTHWEST GAS    APP                        PPD ID: 4880085720,-31.97,ACH_DEBIT,1458.71
DEBIT,12/8/2020,WHOLEFDS SCT 10246 PHOENIX AZ                12/07,-4.38,DEBIT_CARD,1490.68
DEBIT,12/7/2020,VZWRLSS*BILL PAY VN 800-922-0204 FL          12/05,-78.72,DEBIT_CARD,1495.06
DEBIT,12/7/2020,DISCOVER         E-PAYMENT  2463            WEB ID: 2510020270,-192.98,ACH_DEBIT,1573.78
DEBIT,12/7/2020,FRY'S FOOD DRG 120 SCOTTSDALE AZ             12/06,-76.13,DEBIT_CARD,1766.76
DEBIT,12/7/2020,CULVERS OF SCOTTSDALE SCOTTSDALE AZ          12/05,-19.21,DEBIT_CARD,1842.89
DEBIT,12/7/2020,TORTILLA FLAT - MAIN TORTILLA FLAT AZ        12/05,-7.25,DEBIT_CARD,1862.1
DEBIT,12/4/2020,Online Transfer to SAV ...9797 transaction#: 10756729263 12/04,-1200,ACCT_XFER,1869.35
DEBIT,12/4/2020,Online Payment 10755648571 To ALA 5817 12/04,-432.61,LOAN_PMT,3069.35
CREDIT,12/4/2020,CVO HOLDING COMP DIRECT DEP                 PPD ID: 9111111101,2470.05,ACH_CREDIT,3501.96
DEBIT,12/3/2020,GCU STUDENT UNION PHOENIX AZ                 12/02,-7.59,DEBIT_CARD,1031.91
DEBIT,12/1/2020,GOOGLE *YouTube Music 855-836-3987 CA        11/30,-10.85,DEBIT_CARD,1039.5
DEBIT,12/1/2020,FID BKG SVC LLC  MONEYLINE                  PPD ID: 0368004600,-1000,ACH_DEBIT,1050.35
DEBIT,11/30/2020,COSTCO GAS #0427 SCOTTSDALE AZ       024178  11/29,-28.74,DEBIT_CARD,2050.35
DEBIT,11/30/2020,PF CHANGS #5300 OLO 111-111-1111 AZ          11/29,-37.94,DEBIT_CARD,2079.09
DEBIT,11/30/2020,REI #56 PARADISE VAL 1 PHOENIX AZ            11/28,-124.23,DEBIT_CARD,2117.03
CREDIT,11/30/2020,VENMO            CASHOUT                    PPD ID: 5264681992,80,ACH_CREDIT,2241.26
CREDIT,11/30/2020,Online Transfer from SAV ...9797 transaction#: 10716275632,200,ACCT_XFER,2161.26
DEBIT,11/27/2020,WHOLEFDS SCT 102 7111 PHOENIX AZ             11/27 Purchase $3.69 Cash Back $20.00,-23.69,DEBIT_CARD,1961.26
DEBIT,11/27/2020,WHOLEFDS SCT 10246 PHOENIX AZ                11/26,-4.68,DEBIT_CARD,1984.95
DEBIT,11/27/2020,PP*QOSMICQADENCELLC PHOENIX AZ               11/25,-24,DEBIT_CARD,1989.63
DEBIT,11/27/2020,CENTRAL FILLMORE DEV 1 PHOENIX AZ            11/25,-8,DEBIT_CARD,2013.63
DEBIT,11/27/2020,CHEVRON 0207055 SCOTTSDALE AZ                11/25,-20.01,DEBIT_CARD,2021.63
DEBIT,11/27/2020,SQ *PRESS SCOTTSDALE QU Phoenix AZ           11/25,-3.97,DEBIT_CARD,2041.64
DEBIT,11/25/2020,BEST BUY      00008706 SCOTTSDALE AZ 965010  11/25,-300.39,DEBIT_CARD,2045.61
DEBIT,11/25/2020,WHOLEFDS SCT 10246 PHOENIX AZ                11/24,-11.28,DEBIT_CARD,2346
CREDIT,11/25/2020,Online Transfer from SAV ...9797 transaction#: 10700199564,200,ACCT_XFER,2357.28
DEBIT,11/24/2020,CULINARY DROPOUT SCOTTSDALE AZ               11/23,-20.95,DEBIT_CARD,2157.28
DEBIT,11/24/2020,A. WILLIAM CHOULES DDS PHOENIX AZ            11/23,-11,DEBIT_CARD,2178.23
DEBIT,11/24/2020,WHOLEFDS SCT 10246 PHOENIX AZ                11/23,-13.38,DEBIT_CARD,2189.23
DEBIT,11/23/2020,GABLES-1JP20466  WEB PMTS   F9G1R6          WEB ID: 9000326709,-1350,ACH_DEBIT,2202.61
DEBIT,11/23/2020,WHOLEFDS SCT 10246 PHOENIX AZ                11/22,-9.67,DEBIT_CARD,3552.61
DEBIT,11/23/2020,SQ *PRESS SCOTTSDALE QU Scottsdale AZ        11/21,-32.71,DEBIT_CARD,3562.28
DEBIT,11/23/2020,STARBUCKS STORE 62567 PHOENIX AZ             11/20,-3.2,DEBIT_CARD,3594.99
DEBIT,11/20/2020,DISCOVER         E-PAYMENT  2463            WEB ID: 2510020270,-207.28,ACH_DEBIT,3598.19
DEBIT,11/20/2020,BEST GAS MART PHOENIX AZ                     11/19,-15,DEBIT_CARD,3805.47
DEBIT,11/20/2020,GCU STUDENT UNION PHOENIX AZ                 11/19,-8.01,DEBIT_CARD,3820.47
DEBIT,11/20/2020,GCU STUDENT UNION PHOENIX AZ                 11/19,-6.28,DEBIT_CARD,3828.48
DEBIT,11/20/2020,190PEPSIVEN9147678600 PHOENIX AZ             11/19,-1.5,DEBIT_CARD,3834.76
DEBIT,11/20/2020,STARBUCKS STORE 62567 PHOENIX AZ             11/19,-2.66,DEBIT_CARD,3836.26
CREDIT,11/20/2020,CVO HOLDING COMP DIRECT DEP                 PPD ID: 9111111101,2470.05,ACH_CREDIT,3838.92
DEBIT,11/19/2020,WHOLEFDS SCT 10246 PHOENIX AZ                11/18,-11.38,DEBIT_CARD,1368.87
DEBIT,11/19/2020,190PEPSIVEN9147678600 PHOENIX AZ             11/18,-1.5,DEBIT_CARD,1380.25
DEBIT,11/18/2020,SPORT CLIPS - AZ126 SCOTTSDALE AZ            11/17,-28,DEBIT_CARD,1381.75
DEBIT,11/16/2020,SAFEWAY #1253 SCOTTSDALE AZ                  11/15,-133.17,DEBIT_CARD,1409.75
DEBIT,11/16/2020,PAYPAL *MEDIUM.COM 402-935-7733 CA           11/15,-5,DEBIT_CARD,1542.92
DEBIT,11/16/2020,ELEVATE COFFEE COMPANY PHOENIX AZ            11/15,-6.88,DEBIT_CARD,1547.92
DEBIT,11/16/2020,CIRCLE K 05915 SCOTTSDALE AZ                 11/14,-1.82,DEBIT_CARD,1554.8
DEBIT,11/16/2020,SUSHI BROKERS SCOTTSDALE AZ                  11/15,-61.01,DEBIT_CARD,1556.62
DEBIT,11/16/2020,ELEVATE COFFEE COMPANY PHOENIX AZ            11/14,-7.4,DEBIT_CARD,1617.63
DEBIT,11/16/2020,SHELL OIL 10015716003 SCOTTSDALE AZ          11/13,-11.76,DEBIT_CARD,1625.03
DEBIT,11/16/2020,190PEPSIVEN9147678600 PHOENIX AZ             11/13,-1.75,DEBIT_CARD,1636.79
DEBIT,11/13/2020,WHOLEFDS SCT 10246 PHOENIX AZ                11/12,-47.05,DEBIT_CARD,1638.54
DEBIT,11/13/2020,GCU STUDENT UNION PHOENIX AZ                 11/12,-5.09,DEBIT_CARD,1685.59
DEBIT,11/13/2020,STARBUCKS STORE 62567 PHOENIX AZ             11/12,-3.2,DEBIT_CARD,1690.68
DEBIT,11/10/2020,HLU*Hulu 16100496551 HULU.COM/BILL CA        11/10,-12.94,DEBIT_CARD,1693.88
DEBIT,11/10/2020,APS electric pmt PAYMENT    3518057919      WEB ID: 1860011170,-96.55,ACH_DEBIT,1706.82
DEBIT,11/10/2020,WHOLEFDS SCT 10246 PHOENIX AZ                11/09,-13.36,DEBIT_CARD,1803.37
DEBIT,11/9/2020,SOUTHWEST GAS    WEB        4216220870021   WEB ID: 5880085720,-48.46,ACH_DEBIT,1816.73
DEBIT,11/9/2020,VZWRLSS*BILL PAY VN 800-922-0204 FL          11/07,-78.72,DEBIT_CARD,1865.19
DEBIT,11/9/2020,WHOLEFDS SCT 10246 PHOENIX AZ                11/08,-22.97,DEBIT_CARD,1943.91
DEBIT,11/9/2020,ELEVATE COFFEE COMPANY PHOENIX AZ            11/08,-6.88,DEBIT_CARD,1966.88
DEBIT,11/9/2020,ELEVATE COFFEE COMPANY PHOENIX AZ            11/07,-8.83,DEBIT_CARD,1973.76
DEBIT,11/9/2020,FATE BREWING TEMPE TEMPE AZ                  11/07,-24,DEBIT_CARD,1982.59
DEBIT,11/9/2020,GCU STUDENT UNION PHOENIX AZ                 11/06,-5.3,DEBIT_CARD,2006.59
DEBIT,11/6/2020,Online Transfer to SAV ...9797 transaction#: 10593155262 11/06,-1000,ACCT_XFER,2011.89
DEBIT,11/6/2020,Online Payment 10593112040 To ALA 5817 11/06,-432.61,LOAN_PMT,3011.89
DEBIT,11/6/2020,GCU STUDENT UNION PHOENIX AZ                 11/05,-2.16,DEBIT_CARD,3444.5
DEBIT,11/6/2020,TOPGOLF RIVERWALK 013-2 SCOTTSDALE AZ        11/03,-39.4,DEBIT_CARD,3446.66
CREDIT,11/6/2020,CVO HOLDING COMP DIRECT DEP                 PPD ID: 9111111101,2470.05,ACH_CREDIT,3486.06
DEBIT,11/3/2020,STAPLES 0715 SCOTTSDALE AZ           057094  11/03,-21.56,DEBIT_CARD,1016.01
DEBIT,11/2/2020,GOOGLE *YouTube Music 855-836-3987 CA        10/30,-10.85,DEBIT_CARD,1037.57
DEBIT,11/2/2020,FID BKG SVC LLC  MONEYLINE                  PPD ID: 0368004600,-1000,ACH_DEBIT,1048.42
DEBIT,11/2/2020,COSTCO WHSE #0427 SCOTTSDALE AZ      751574  11/02,-85.34,DEBIT_CARD,2048.42
DEBIT,11/2/2020,GRIMALDI'S PIZZA #01107 SCOTTSDALE AZ        11/01,-22.69,DEBIT_CARD,2133.76
DEBIT,11/2/2020,ELEVATE COFFEE COMPANY PHOENIX AZ            11/01,-4.94,DEBIT_CARD,2156.45
DEBIT,11/2/2020,BREAKFAST KITCHEN BAR S SCOTTSDALE AZ        11/01,-33.09,DEBIT_CARD,2161.39
DEBIT,11/2/2020,STAPLES 0715 SCOTTSDALE AZ           749708  10/31,-4.85,DEBIT_CARD,2194.48
DEBIT,11/2/2020,COSTCO GAS #0738 PHOENIX AZ          016180  10/31,-34.13,DEBIT_CARD,2199.33
DEBIT,11/2/2020,ELEVATE COFFEE COMPANY PHOENIX AZ            10/31,-15.34,DEBIT_CARD,2233.46
DEBIT,11/2/2020,ELEVATE COFFEE COMPANY PHOENIX AZ            10/31,-7.22,DEBIT_CARD,2248.8
DEBIT,11/2/2020,TRUE FOOD KITCHEN #1003 SCOTTSDALE AZ        10/30,-26.96,DEBIT_CARD,2256.02
CREDIT,11/2/2020,Online Transfer from SAV ...9797 transaction#: 10561395586,300,ACCT_XFER,2282.98
DEBIT,10/30/2020,CVS/PHARMACY #10529 SCOTTSDALE AZ            10/29,-2.19,DEBIT_CARD,1982.98
DEBIT,10/29/2020,DOORDASH*PEI WEI ASI WWW.DOORDASH. CA        10/28,-38.06,DEBIT_CARD,1985.17
DEBIT,10/29/2020,TOPGOLF RIVERWALK 013-2 SCOTTSDALE AZ        10/28,-35.61,DEBIT_CARD,2023.23
DEBIT,10/26/2020,GABLES-1JP20466  WEB PMTS   R21FL6          WEB ID: 9000326709,-1321,ACH_DEBIT,2058.84
DEBIT,10/26/2020,COSTCO WHSE #0427 SCOTTSDALE AZ      187178  10/25,-54.8,DEBIT_CARD,3379.84
DEBIT,10/26/2020,SQ *PRESS SCOTTSDALE QU Scottsdale AZ        10/25,-8.29,DEBIT_CARD,3434.64
DEBIT,10/26/2020,STARBUCKS STORE 02940 SCOTTSDALE AZ          10/24,-7.13,DEBIT_CARD,3442.93
DEBIT,10/26/2020,GRIMALDI'S PIZZA #01107 SCOTTSDALE AZ        10/23,-44.82,DEBIT_CARD,3450.06
DEBIT,10/23/2020,FRY'S FOOD DRG 0673 SCOTTSDALE AZ            10/22,-22.34,DEBIT_CARD,3494.88
DEBIT,10/23/2020,CVS/PHARMACY #10529 SCOTTSDALE AZ            10/22,-16.8,DEBIT_CARD,3517.22
DEBIT,10/23/2020,CVS/PHARMACY #10529 SCOTTSDALE AZ            10/22,-5.16,DEBIT_CARD,3534.02
DEBIT,10/23/2020,190PEPSIVEN9147678600 PHOENIX AZ             10/21,-2,DEBIT_CARD,3539.18
CREDIT,10/23/2020,CVO HOLDING COMP DIRECT DEP                 PPD ID: 9111111101,2470.05,ACH_CREDIT,3541.18
DEBIT,10/22/2020,TOPGOLF RIVERWALK 013-2 SCOTTSDALE AZ        10/21,-70,DEBIT_CARD,1071.13
DEBIT,10/20/2020,A. WILLIAM CHOULES DDS PHOENIX AZ            10/19,-9,DEBIT_CARD,1141.13
DEBIT,10/20/2020,SAFEWAY #1750 SCOTTSDALE AZ                  10/19,-68.44,DEBIT_CARD,1150.13
DEBIT,10/19/2020,CULINARY DROPOUT SCOTTSDALE AZ               10/18,-42.93,DEBIT_CARD,1218.57
DEBIT,10/19/2020,BJS RESTAURANTS 447 PHOENIX AZ               10/17,-27.52,DEBIT_CARD,1261.5
DEBIT,10/19/2020,WHOLEFDS SCT 10246 PHOENIX AZ                10/16,-8.98,DEBIT_CARD,1289.02
DEBIT,10/19/2020,CIRCLE K # 03459 PHOENIX AZ                  10/16,-39.96,DEBIT_CARD,1298
DEBIT,10/19/2020,STARBUCKS STORE 02940 SCOTTSDALE AZ          10/16,-3.19,DEBIT_CARD,1337.96
DEBIT,10/16/2020,FRY'S FOOD DRG 0673 SCOTTSDALE AZ            10/14,-35.94,DEBIT_CARD,1341.15
DEBIT,10/16/2020,LUCI'S AT THE ORCHARD PHOENIX AZ             10/15,-13.68,DEBIT_CARD,1377.09
DEBIT,10/15/2020,STARBUCKS STORE 02940 SCOTTSDALE AZ          10/14,-3.19,DEBIT_CARD,1390.77
DEBIT,10/14/2020,DISCOVER         E-PAYMENT  2463            WEB ID: 2510020270,-750.51,ACH_DEBIT,1393.96
DEBIT,10/14/2020,STARBUCKS STORE 02940 SCOTTSDALE AZ          10/13,-7.13,DEBIT_CARD,2144.47
DEBIT,10/13/2020,HLU*Hulu 16100496565 HULU.COM/BILL CA        10/10,-12.94,DEBIT_CARD,2151.6
DEBIT,10/13/2020,APS electric pmt PAYMENT    3518057919      WEB ID: 1860011170,-175.69,ACH_DEBIT,2164.54
DEBIT,10/13/2020,STARBUCKS STORE 02940 SCOTTSDALE AZ          10/11,-3.19,DEBIT_CARD,2340.23
DEBIT,10/13/2020,TST* BARRIO QUEEN - DES PHOENIX AZ           10/11,-54.64,DEBIT_CARD,2343.42
DEBIT,10/13/2020,STARBUCKS STORE 02940 SCOTTSDALE AZ          10/10,-2.86,DEBIT_CARD,2398.06
DEBIT,10/13/2020,SCOTTSDALE BICYCLE CO SCOTTSDALE AZ          10/08,-106.43,DEBIT_CARD,2400.92
CREDIT,10/13/2020,VENMO            CASHOUT                    PPD ID: 5264681992,416,ACH_CREDIT,2507.35
DEBIT,10/9/2020,VZWRLSS*BILL PAY VN 800-922-0204 FL          10/09,-78.69,DEBIT_CARD,2091.35
DEBIT,10/9/2020,Online Payment 10434045932 To ALA 5817 10/09,-432.61,LOAN_PMT,2170.04
DEBIT,10/9/2020,Online Transfer to SAV ...9797 transaction#: 10434035364 10/09,-1000,ACCT_XFER,2602.65
DEBIT,10/9/2020,SAFEWAY #1253 SCOTTSDALE AZ                  10/08,-80.04,DEBIT_CARD,3602.65
CREDIT,10/9/2020,CVO HOLDING COMP DIRECT DEP                 PPD ID: 9111111101,2470.06,ACH_CREDIT,3682.69
DEBIT,10/7/2020,ARCO #42554 AMPM PHOENIX AZ                  10/07,-22.46,DEBIT_CARD,1212.63
DEBIT,10/7/2020,SPORT CLIPS - AZ126 SCOTTSDALE AZ            10/06,-28,DEBIT_CARD,1235.09
DEBIT,10/7/2020,Amazon.com*MK4EA21I2 Amzn.com/bill WA        10/06,-98.01,DEBIT_CARD,1263.09
DEBIT,10/5/2020,BEST BUY         PAYMENT    160237463798885 WEB ID: CITICTP,-1601.98,ACH_DEBIT,1361.1
DEBIT,10/5/2020,FRY'S FOOD DRG 0673 SCOTTSDALE AZ            10/04,-106.31,DEBIT_CARD,2963.08
DEBIT,10/5/2020,SNOOZE AN AM EATERY KIE SCOTTSDALE AZ        10/04,-39,DEBIT_CARD,3069.39
DEBIT,10/5/2020,OHSO BREWERY PV PHOENIX AZ                   10/03,-18.74,DEBIT_CARD,3108.39
DEBIT,10/5/2020,LUCI'S AT THE ORCHARD PHOENIX AZ             10/03,-17.37,DEBIT_CARD,3127.13
CREDIT,10/5/2020,VENMO            CASHOUT                    PPD ID: 5264681992,53,ACH_CREDIT,3144.5
CREDIT,10/5/2020,Online Transfer from SAV ...9797 transaction#: 10411340339,300,ACCT_XFER,3091.5
DEBIT,10/2/2020,BEST BUY         AUTO PYMT  720211576530346 WEB ID: CITIAUTFDR,-100,ACH_DEBIT,2791.5
DEBIT,10/2/2020,WEIDNER-WF-DPTEX WEB PMTS   JQQ8H6          WEB ID: 9000200905,-560.75,ACH_DEBIT,2891.5
DEBIT,10/2/2020,TARGET        00032615 PHOENIX AZ            10/01,-12.19,DEBIT_CARD,3452.25
DEBIT,10/2/2020,PERMIT/CITATION PRKGS 805-562-8200 CA        10/01,-150,DEBIT_CARD,3464.44
DEBIT,10/2/2020,OHSO BREWERY PV PHOENIX AZ                   09/30,-50.35,DEBIT_CARD,3614.44
DEBIT,10/1/2020,GOOGLE *YouTube Music 855-836-3987 CA        09/30,-10.85,DEBIT_CARD,3664.79
DEBIT,10/1/2020,FID BKG SVC LLC  MONEYLINE                  PPD ID: 0368004600,-1000,ACH_DEBIT,3675.64
DEBIT,10/1/2020,A. WILLIAM CHOULES DDS PHOENIX AZ            09/30,-11,DEBIT_CARD,4675.64
CREDIT,10/1/2020,Online Transfer from SAV ...9797 transaction#: 10389337458,1700,ACCT_XFER,4686.64
DEBIT,9/30/2020,ELEVATE COFFEE COMPANY PHOENIX AZ            09/29,-4.15,DEBIT_CARD,2986.64
DEBIT,9/29/2020,GABLES-1JP20466  WEB PMTS   RK20G6          WEB ID: 9000326709,-1516.85,ACH_DEBIT,2990.79
DEBIT,9/29/2020,FIVERR * 9543682267 NY                       09/28,-7,DEBIT_CARD,4507.64
DEBIT,9/29/2020,LUCI'S AT THE ORCHARD PHOENIX AZ             09/28,-28.33,DEBIT_CARD,4514.64
CREDIT,9/29/2020,Online Transfer from SAV ...9797 transaction#: 10369806379,1000,ACCT_XFER,4542.97
DEBIT,9/28/2020,WHOLEFDS CMA #10476 PHOENIX AZ               09/27,-41.44,DEBIT_CARD,3542.97
DEBIT,9/28/2020,CULINARY DROPOUT PHOENIX AZ                  09/26,-7.15,DEBIT_CARD,3584.41
DEBIT,9/28/2020,SQ *PRESS BILTMORE Phoenix AZ                09/26,-3.98,DEBIT_CARD,3591.56
DEBIT,9/28/2020,GRIMALDI'S PIZZA #01101 SCOTTSDALE AZ        09/25,-25.07,DEBIT_CARD,3595.54
DEBIT,9/28/2020,LUCI'S AT THE ORCHARD PHOENIX AZ             09/25,-17.91,DEBIT_CARD,3620.61
DEBIT,9/25/2020,WHOLEFDS CMA #10476 PHOENIX AZ               09/24,-43.67,DEBIT_CARD,3638.52
DEBIT,9/25/2020,SORSO WINE ROOM SCOTTSDALE AZ                09/23,-32.01,DEBIT_CARD,3682.19
CREDIT,9/25/2020,CVO HOLDING COMP DIRECT DEP                 PPD ID: 9111111101,2470.04,ACH_CREDIT,3714.2
DEBIT,9/24/2020,SHELL SERVICE STATION PHOENIX AZ     047765  09/24,-38.72,DEBIT_CARD,1244.16
DEBIT,9/24/2020,Online Transfer to SAV ...9797 transaction#: 10343466451 09/24,-500,ACCT_XFER,1282.88
DEBIT,9/24/2020,ARROWHEAD AUTO GLASS PEORIA AZ               09/23,-428,DEBIT_CARD,1782.88
CREDIT,9/24/2020,Online Transfer 10331139308 from Fifth Third Checking ######0462 transaction #: 10331139308 09/24,500,ACCT_XFER,2210.88
DEBIT,9/23/2020,WHOLEFDS CMA #10476 PHOENIX AZ               09/22,-11.98,DEBIT_CARD,1710.88
DEBIT,9/23/2020,TRADER JOE'S #090  QPS PHOENIX AZ            09/22,-68.18,DEBIT_CARD,1722.86
DEBIT,9/23/2020,LUCIS* LUCIS AT THE HTTPSWWW.LUCI AZ         09/22,-11.39,DEBIT_CARD,1791.04
DEBIT,9/23/2020,CAMELBACK VW MAZDA SUB PHOENIX AZ            09/22,-662.47,DEBIT_CARD,1802.43
CREDIT,9/23/2020,VENMO            CASHOUT                    PPD ID: 5264681992,34,ACH_CREDIT,2464.9
CREDIT,9/23/2020,ATM CASH DEPOSIT 09/23 5041 N 16TH ST PHOENIX AZ,200,ATM,2430.9
DEBIT,9/21/2020,TARGET        00032615 PHOENIX AZ            09/20,-52.1,DEBIT_CARD,2230.9
DEBIT,9/21/2020,LOVE S COUNTRY00002154 GALLUP NM             09/20,-5.08,DEBIT_CARD,2283
DEBIT,9/21/2020,MCDONALD'S F31869 ALBUQUERQUE NM             09/20,-13.53,DEBIT_CARD,2288.08
DEBIT,9/21/2020,SHELL OIL 57445818404 CALUMET OK             09/19,-7.55,DEBIT_CARD,2301.61
DEBIT,9/21/2020,QT 23 SAND SPRINGS OK                        09/19,-5.96,DEBIT_CARD,2309.16
DEBIT,9/21/2020,COURTYARD BY MARRIOTT TULSA OK               09/19,-26.57,DEBIT_CARD,2315.12
DEBIT,9/21/2020,SECURE PARKING 11 TULSA OK                   09/18,-16,DEBIT_CARD,2341.69
DEBIT,9/21/2020,COURTYARD BY MARRIOTT TULSA OK               09/20,-106.71,DEBIT_CARD,2357.69
DEBIT,9/21/2020,PHILLIPS 66 - PRIGMORE JOPLIN MO             09/18,-2.09,DEBIT_CARD,2464.4
DEBIT,9/21/2020,BREAK TIME 3162 ROLLA MO                     09/18,-7.68,DEBIT_CARD,2466.49
DEBIT,9/21/2020,CIRCLE K 00180 MOMENCE IL                    09/18,-4.02,DEBIT_CARD,2474.17
CREDIT,9/21/2020,Online Transfer from SAV ...9797 transaction#: 10329308725,1000,ACCT_XFER,2478.19
DEBIT,9/18/2020,Amazon Prime*MU0IW0Y Amzn.com/bill WA        09/18,-14.11,DEBIT_CARD,1478.19
DEBIT,9/18/2020,COURTYARD BY MARRIOTT ALBUQUERQUE NM         09/18,-115.06,DEBIT_CARD,1492.3
DEBIT,9/18/2020,A-1 HITCH LLC MERRILLVILLE IN                09/17,-325.75,DEBIT_CARD,1607.36
DEBIT,9/17/2020,STRACK & VAN TIL #8787 CROWN POINT IN        09/16,-24.59,DEBIT_CARD,1933.11
DEBIT,9/16/2020,WALGREENS STORE 1520 S CROWN POINT IN034350  09/16,-14.94,DEBIT_CARD,1957.7
DEBIT,9/15/2020,APS electric pmt PAYMENT    3518057919      WEB ID: 1860011170,-70.11,ACH_DEBIT,1972.64
DEBIT,9/14/2020,VZWRLSS*BILL PAY VN 800-922-0204 FL          09/12,-78.69,DEBIT_CARD,2042.75
DEBIT,9/14/2020,BP#8631186VIRKS VEER MICHIGAN CITY IN        09/13,-5.19,DEBIT_CARD,2121.44
DEBIT,9/14/2020,BIGGBY COFFEE #342 MARSHALL MI               09/13,-7.93,DEBIT_CARD,2126.63
DEBIT,9/14/2020,SPEEDWAY 02355 A 1490 PLYMOUTH MI    462684  09/13,-24.09,DEBIT_CARD,2134.56
DEBIT,9/14/2020,EPC*EPIC GAMES STORE 919-854-0070 NC         09/13,-24.99,DEBIT_CARD,2158.65
DEBIT,9/14/2020,STRACK & VAN TIL #8787 CROWN POINT IN        09/11,-5.42,DEBIT_CARD,2183.64
CREDIT,9/14/2020,VENMO            CASHOUT                    PPD ID: 5264681992,70,ACH_CREDIT,2189.06
DEBIT,9/11/2020,Online Transfer to SAV ...9797 transaction#: 10277111668 09/11,-1000,ACCT_XFER,2119.06
DEBIT,9/11/2020,Online Payment 10277096226 To ALA 5817 09/11,-432.61,LOAN_PMT,3119.06
CREDIT,9/11/2020,CVO HOLDING COMP DIRECT DEP                 PPD ID: 9111111101,2470.06,ACH_CREDIT,3551.67
DEBIT,9/10/2020,HLU*Hulu 16100496505 HULU.COM/BILL CA        09/10,-13.03,DEBIT_CARD,1081.61
DEBIT,9/9/2020,STRACK & VAN TIL #8787 CROWN POINT IN        09/08,-23,DEBIT_CARD,1094.64
DEBIT,9/8/2020,STRACK & VAN TIL #8787 CROWN POINT IN        09/07,-32.38,DEBIT_CARD,1117.64
DEBIT,9/8/2020,STEAMWHISTLE COFFEE RO CROWN POINT IN        09/05,-11.48,DEBIT_CARD,1150.02
DEBIT,9/8/2020,STRACK & VAN TIL #8756 CEDAR LAKE IN         09/04,-19,DEBIT_CARD,1161.5
DEBIT,9/8/2020,LUKE FUEL STATION CEDAR LAKE IN              09/04,-33.72,DEBIT_CARD,1180.5
DEBIT,9/8/2020,STEAMWHISTLE COFFEE RO CROWN POINT IN        09/03,-2.51,DEBIT_CARD,1214.22
DEBIT,9/3/2020,STEAMWHISTLE COFFEE RO CROWN POINT IN        09/01,-2.51,DEBIT_CARD,1216.73
DEBIT,9/2/2020,WEIDNER-WF-DPTEX WEB PMTS   1V1QB6          WEB ID: 9000200905,-1446.3,ACH_DEBIT,1219.24
DEBIT,9/2/2020,STEAMWHISTLE COFFEE RO CROWN POINT IN        08/31,-2.51,DEBIT_CARD,2665.54
DEBIT,9/1/2020,FID BKG SVC LLC  MONEYLINE                  PPD ID: 0368004600,-1000,ACH_DEBIT,2668.05
DEBIT,9/1/2020,STEAMWHISTLE COFFEE RO CROWN POINT IN        08/30,-2.51,DEBIT_CARD,3668.05
DEBIT,9/1/2020,STEAMWHISTLE COFFEE RO CROWN POINT IN        08/30,-2.51,DEBIT_CARD,3670.56
DEBIT,8/31/2020,GOOGLE*YOUTUBE MUSIC INTERNET CA             08/30,-10.85,DEBIT_CARD,3673.07
DEBIT,8/31/2020,CVS/PHARMACY #03398 CROWN POINT IN           08/29,-192.85,DEBIT_CARD,3683.92
DEBIT,8/31/2020,STRACK & VAN TIL #8787 CROWN POINT IN        08/29,-35.57,DEBIT_CARD,3876.77
DEBIT,8/31/2020,STEAMWHISTLE COFFEE RO CROWN POINT IN        08/29,-2.51,DEBIT_CARD,3912.34
DEBIT,8/31/2020,WALGREENS STORE 1520 S CROWN POINT IN130860  08/29,-3.95,DEBIT_CARD,3914.85
DEBIT,8/31/2020,CARRIAGE COURT PIZZA CROWN POINT IN          08/29,-23.21,DEBIT_CARD,3918.8
DEBIT,8/31/2020,HUMBLEBUNDLE.COM HTTPSWWW.HUMB CA            08/28,-29.99,DEBIT_CARD,3942.01
DEBIT,8/28/2020,CULVERS OF CROWN POINT CROWN POINT IN        08/27,-9.62,DEBIT_CARD,3972
CREDIT,8/28/2020,CVO HOLDING COMP DIRECT DEP                 PPD ID: 9111111101,2470.05,ACH_CREDIT,3981.62
DEBIT,8/27/2020,STEAMWHISTLE COFFEE RO CROWN POINT IN        08/25,-5.02,DEBIT_CARD,1511.57
DEBIT,8/25/2020,STRACK & VAN TIL #8787 CROWN POINT IN        08/24,-17.99,DEBIT_CARD,1516.59
DEBIT,8/25/2020,STEAMWHISTLE COFFEE RO CROWN POINT IN        08/23,-5.02,DEBIT_CARD,1534.58
DEBIT,8/24/2020,SPORT CLIPS - IN605 - CROWN POINT IN         08/23,-30,DEBIT_CARD,1539.6
DEBIT,8/24/2020,PP*CHEMSHAW13D CROWN POINT IN                08/23,-8.95,DEBIT_CARD,1569.6
DEBIT,8/24/2020,CROWN POINT TRUE VALUE CROWN POINT IN        08/22,-14.97,DEBIT_CARD,1578.55
DEBIT,8/24/2020,BEST BUY #309 MERRILLVILLE IN        237351  08/22,-74.89,DEBIT_CARD,1593.52
DEBIT,8/24/2020,SPEEDWAY 02355 A 1490 PLYMOUTH MI    005123  08/22,-33.57,DEBIT_CARD,1668.41
DEBIT,8/24/2020,SQ *ESPRESSO ELEVADO gosq.com MI             08/22,-3.45,DEBIT_CARD,1701.98
DEBIT,8/24/2020,PICNIC BASKET MARKET PLYMOUTH MI             08/21,-3.28,DEBIT_CARD,1705.43
DEBIT,8/24/2020,PLYMOUTH COFFEE BEAN- 248-8727392 MI         08/21,-3.9,DEBIT_CARD,1708.71
DEBIT,8/21/2020,CVS/PHARMACY #08208 PLYMOUTH MI              08/20,-6,DEBIT_CARD,1712.61
DEBIT,8/21/2020,PICNIC BASKET MARKET PLYMOUTH MI             08/20,-14.05,DEBIT_CARD,1718.61
DEBIT,8/21/2020,THE HUDSON'S CAFE DETROIT MI                 08/20,-37.8,DEBIT_CARD,1732.66
DEBIT,8/21/2020,CITY OF DETROIT MUN PAR DETROIT MI           08/20,-2,DEBIT_CARD,1770.46
DEBIT,8/20/2020,CITY OF DETROIT MUNPL. DETROIT MI            08/19,-1,DEBIT_CARD,1772.46
DEBIT,8/19/2020,SQ *DESSERT OASIS COFFE Detroit MI           08/19,-10.56,DEBIT_CARD,1773.46
CREDIT,8/19/2020,IRS  TREAS 310     TAX REF                  PPD ID: 9111036170,14.33,ACH_CREDIT,1784.02
DEBIT,8/18/2020,Amazon Prime*MM3CD2V Amzn.com/bill WA        08/18,-14.11,DEBIT_CARD,1769.69
DEBIT,8/18/2020,SQ *AWAKE CAFE COFFEE A Detroit MI           08/18,-14.05,DEBIT_CARD,1783.8
DEBIT,8/18/2020,TST* IMA 1 DETROIT MI                        08/17,-36.54,DEBIT_CARD,1797.85
DEBIT,8/18/2020,DOORDASH*BUCHAREST G WWW.DOORDASH. CA        08/17,-17.08,DEBIT_CARD,1834.39
DEBIT,8/18/2020,JERSEY MIKES 31024 FERNDALE MI               08/16,-17.2,DEBIT_CARD,1851.47
DEBIT,8/17/2020,VZWRLSS*BILL PAY VN 800-922-0204 FL          08/15,-79.44,DEBIT_CARD,1868.67
DEBIT,8/17/2020,VENMO            PAYMENT    3927597619      WEB ID: 3264681992,-109,ACH_DEBIT,1948.11
DEBIT,8/17/2020,SQ *COLD TRUTH LLC Detroit MI                08/16,-7.83,DEBIT_CARD,2057.11
DEBIT,8/17/2020,CVS/PHARMACY #08267 DETROIT MI               08/16,-18.54,DEBIT_CARD,2064.94
DEBIT,8/17/2020,DOORDASH*PAPA ROMANO WWW.DOORDASH. CA        08/16,-17.03,DEBIT_CARD,2083.48
DEBIT,8/17/2020,DETROIT FLEAT FERNDALE MI                    08/15,-24.21,DEBIT_CARD,2100.51
DEBIT,8/17/2020,FAMILY EXPRESS #65 CROWN POINT IN            08/14,-38.57,DEBIT_CARD,2124.72
DEBIT,8/17/2020,SIP COFFEE HOUSE WINFIELD IN                 08/14,-30.95,DEBIT_CARD,2163.29
DEBIT,8/14/2020,Online Transfer to SAV ...9797 transaction#: 10115962068 08/14,-1000,ACCT_XFER,2194.24
DEBIT,8/14/2020,Online Payment 10115931474 To ALA 5817 08/14,-432.61,LOAN_PMT,3194.24
CREDIT,8/14/2020,CVO HOLDING COMP DIRECT DEP                 PPD ID: 9111111101,2470.05,ACH_CREDIT,3626.85
DEBIT,8/12/2020,APS electric pmt PAYMENT    3518057919      WEB ID: 1860011170,-68.63,ACH_DEBIT,1156.8
DEBIT,8/12/2020,CHIPOTLE 3282 CROWN POINT IN                 08/11,-9.15,DEBIT_CARD,1225.43
DEBIT,8/11/2020,DISCOVER         E-PAYMENT  2463            WEB ID: 2510020270,-317.12,ACH_DEBIT,1234.58
DEBIT,8/10/2020,HLU*Hulu 16100496526 HULU.COM/BILL CA        08/10,-13.03,DEBIT_CARD,1551.7
DEBIT,8/10/2020,VENMO            PAYMENT    3891944044      WEB ID: 3264681992,-192,ACH_DEBIT,1564.73
DEBIT,8/10/2020,WALGREENS STORE 1520 S CROWN POINT IN420314  08/08,-2.13,DEBIT_CARD,1756.73
DEBIT,8/10/2020,BUCKS BICYCLE SHOP INC VALPARAISO IN         08/08,-32.05,DEBIT_CARD,1758.86
DEBIT,8/10/2020,BUCKS BICYCLE SHOP INC VALPARAISO IN         08/08,-79.5,DEBIT_CARD,1790.91
DEBIT,8/10/2020,SLC CNBC NEWS D SALT LAKE CIT UT             08/07,-6.47,DEBIT_CARD,1870.41
DEBIT,8/10/2020,CHEVRON 0204253 MURRAY UT                    08/07,-23.99,DEBIT_CARD,1876.88
CREDIT,8/10/2020,VENMO            CASHOUT                    PPD ID: 5264681992,69,ACH_CREDIT,1900.87
DEBIT,8/5/2020,WEIDNER-WF-DPTEX WEB PMTS   Q1CH76          WEB ID: 9000200905,-1451.24,ACH_DEBIT,1831.87
DEBIT,8/5/2020,JANS PARK AVE PARK CITY UT                   08/04,-50.42,DEBIT_CARD,3283.11
DEBIT,8/4/2020,JANS PARK AVE PARK CITY UT                   08/03,-18.31,DEBIT_CARD,3333.53
DEBIT,8/3/2020,FID BKG SVC LLC  MONEYLINE                  PPD ID: 0368004600,-1000,ACH_DEBIT,3351.84
DEBIT,8/3/2020,JANS PARK AVE PARK CITY UT                   08/02,-25.92,DEBIT_CARD,4351.84
DEBIT,8/3/2020,JANS PARK AVE PARK CITY UT                   08/01,-107.74,DEBIT_CARD,4377.76
DEBIT,8/3/2020,HUDSONNEWS  ST854 DES PLAINES IL             07/31,-10.3,DEBIT_CARD,4485.5
CREDIT,8/3/2020,Online Transfer from SAV ...9797 transaction#: 10043444228,1000,ACCT_XFER,4495.8
DEBIT,7/31/2020,GOOGLE *YouTube Music 855-836-3987 CA        07/30,-10.85,DEBIT_CARD,3495.8
CREDIT,7/31/2020,CVO HOLDING COMP DIRECT DEP                 PPD ID: 9111111101,2470.05,ACH_CREDIT,3506.65
DEBIT,7/30/2020,STARBUCKS STORE 02653 PLYMOUTH MI            07/29,-9.17,DEBIT_CARD,1036.6
DEBIT,7/29/2020,KELLY EXPRESS M ALBION MI                    07/29,-25,DEBIT_CARD,1045.77
DEBIT,7/29/2020,KELLY EXPRESS M ALBION MI                    07/29,-4.38,DEBIT_CARD,1070.77
DEBIT,7/29/2020,PICNIC BASKET MARKET PLYMOUTH MI             07/28,-2.78,DEBIT_CARD,1075.15
DEBIT,7/27/2020,KROGER 670 PLYMOUTH MI                       07/26,-27.13,DEBIT_CARD,1077.93
DEBIT,7/27/2020,SPEEDWAY 08778 KALAMAZO KALAMAZOO MI         07/24,-7.28,DEBIT_CARD,1105.06
DEBIT,7/27/2020,SIP COFFEE HOUSE CROWN POINT IN              07/25,-26.54,DEBIT_CARD,1112.34
DEBIT,7/24/2020,WALGREENS STORE 1520 S CROWN POINT IN133209  07/24,-71.84,DEBIT_CARD,1138.88
DEBIT,7/24/2020,WALGREENS STORE 1520 S CROWN POINT IN419241  07/24,-37.81,DEBIT_CARD,1210.72
DEBIT,7/24/2020,TST* STACKS BAR & GRILL VALPARAISO IN        07/23,-23.26,DEBIT_CARD,1248.53
DEBIT,7/23/2020,COUNTY SEAT LIQUORS CROWN POINT IN           07/22,-11.76,DEBIT_CARD,1271.79
DEBIT,7/23/2020,CARRIAGE COURT PIZZA CROWN POINT IN          07/22,-48.23,DEBIT_CARD,1283.55
DEBIT,7/23/2020,DELTA AIR   00624287955 DELTA.COM CA         07/22,-554.2,DEBIT_CARD,1331.78
DEBIT,7/22/2020,APS electric pmt PAYMENT    3518057919      WEB ID: 1860011170,-127.15,ACH_DEBIT,1885.98
DEBIT,7/22/2020,WALGREENS STORE 1520 S CROWN POINT IN037787  07/22,-9.93,DEBIT_CARD,2013.13
CREDIT,7/22/2020,Online Transfer from SAV ...9797 transaction#: 9985815063,400,ACCT_XFER,2023.06
DEBIT,7/21/2020,FID BKG SVC LLC  MONEYLINE                  PPD ID: 0368004600,-5000,ACH_DEBIT,1623.06
DEBIT,7/21/2020,STRACK & VAN TIL #8787 CROWN POINT IN        07/20,-18.3,DEBIT_CARD,6623.06
DEBIT,7/21/2020,CHIPOTLE 3282 CROWN POINT IN                 07/20,-19.74,DEBIT_CARD,6641.36
DEBIT,7/21/2020,SPORT CLIPS - IN605 - CROWN POINT IN         07/20,-30,DEBIT_CARD,6661.1
CREDIT,7/21/2020,VENMO            CASHOUT                    PPD ID: 5264681992,53,ACH_CREDIT,6691.1
CREDIT,7/21/2020,VENMO            CASHOUT                    PPD ID: 5264681992,127,ACH_CREDIT,6638.1
DEBIT,7/20/2020,Amazon Prime*MV7F62G Amzn.com/bill WA        07/18,-14.11,DEBIT_CARD,6511.1
DEBIT,7/20/2020,STRACK & VAN TIL #8787 CROWN POINT IN        07/18,-20,DEBIT_CARD,6525.21
DEBIT,7/20/2020,FIREHOUSE SUBS 1462 QSR KALAMAZOO MI         07/17,-16,DEBIT_CARD,6545.21
DEBIT,7/20/2020,SWEETWATERS DONUT MILL KALAMAZOO MI          07/18,-3.27,DEBIT_CARD,6561.21
DEBIT,7/20/2020,MARATHON PETRO45658 ANN ARBOR MI             07/17,-34.54,DEBIT_CARD,6564.48
DEBIT,7/20/2020,TIM HORTONS #916638 SOUTHFIELD MI            07/16,-12.46,DEBIT_CARD,6599.02
DEBIT,7/17/2020,Online Transfer to SAV ...9797 transaction#: 9960627912 07/17,-2000,ACCT_XFER,6611.48
CREDIT,7/17/2020,CVO HOLDING COMP DIRECT DEP                 PPD ID: 9111111101,2470.06,ACH_CREDIT,8611.48
DEBIT,7/16/2020,IN *WOOF LIFE LLC VALPARAISO IN              07/14,-22.47,DEBIT_CARD,6141.42
DEBIT,7/15/2020,STRACK & VAN TIL #8787 CROWN POINT IN        07/14,-34.01,DEBIT_CARD,6163.89
CREDIT,7/15/2020,Online Transfer 9936143685 from Fifth Third Checking ######0462 transaction #: 9936143685 07/15,700,ACCT_XFER,6197.9
DEBIT,7/14/2020,STRACK & VAN TIL #8787 CROWN POINT IN        07/13,-24.38,DEBIT_CARD,5497.9
DEBIT,7/13/2020,WALGREENS STORE 1520 S CROWN POINT IN319205  07/13,-9.69,DEBIT_CARD,5522.28
DEBIT,7/13/2020,COYNE VET CENTER CROWN POINT IN              07/12,-98.5,DEBIT_CARD,5531.97
DEBIT,7/13/2020,TWELVE ISLANDS RESTAUR CROWN POINT IN        07/12,-20.53,DEBIT_CARD,5630.47
DEBIT,7/13/2020,COYNE VET CENTER CROWN POINT IN              07/12,-500,DEBIT_CARD,5651
DEBIT,7/13/2020,ADMIRAL PETROLEUM NILES MI                   07/12,-3.29,DEBIT_CARD,6151
DEBIT,7/13/2020,WALGREENS STORE 907 S NILES MI       423460  07/11,-19.27,DEBIT_CARD,6154.29
DEBIT,7/13/2020,SQ *RUSTY HOOKS BAIT & Niles MI              07/11,-62.07,DEBIT_CARD,6173.56
DEBIT,7/13/2020,FAMILY EXPRESS CROWN POINT IN                07/11,-6.48,DEBIT_CARD,6235.63
DEBIT,7/13/2020,TST* SQUARE ROOTS CROWN POINT IN             07/11,-22.27,DEBIT_CARD,6242.11
DEBIT,7/10/2020,HLU*Hulu 16100496554 HULU.COM/BILL CA        07/10,-13.03,DEBIT_CARD,6264.38
DEBIT,7/10/2020,SPEEDWAY 01020 1 10950 CROWN POINT IN434232  07/10,-37.21,DEBIT_CARD,6277.41
DEBIT,7/10/2020,CARRIAGE COURT PIZZA CROWN POINT IN          07/09,-14.07,DEBIT_CARD,6314.62
DEBIT,7/10/2020,IL TOLLWAY-WEB-UNPD T 800-824-7277 IL        07/09,-19,DEBIT_CARD,6328.69
DEBIT,7/10/2020,TWELVE ISLANDS RESTAUR CROWN POINT IN        07/09,-33.02,DEBIT_CARD,6347.69
CREDIT,7/9/2020,Online Transfer from SAV ...9797 transaction#: 9918537473,5000,ACCT_XFER,6380.71
DEBIT,7/8/2020,COUNTER CHECK,-2,FEE_TRANSACTION,1380.71
DEBIT,7/6/2020,MURPHY6962ATWAL SHELBYVILLE IN               07/05,-25.5,DEBIT_CARD,1382.71
DEBIT,7/6/2020,MURPHY6962ATWAL SHELBYVILLE IN               07/05,-3.58,DEBIT_CARD,1408.21
DEBIT,7/6/2020,SIP COFFEE HOUSE CROWN POINT IN              07/05,-24.65,DEBIT_CARD,1411.79
DEBIT,7/6/2020,Provecho Latin Provisi Crown Point IN        07/04,-28.89,DEBIT_CARD,1436.44
DEBIT,7/3/2020,VZWRLSS*BILL PAY VN 800-922-0204 FL          07/03,-79.18,DEBIT_CARD,1465.33
DEBIT,7/3/2020,TST* STATION 21 AMERIC CROWN POINT IN        07/03,-31.57,DEBIT_CARD,1544.51
DEBIT,7/2/2020,WEIDNER-WF-DPTEX WEB PMTS   QJ3816          WEB ID: 9000200905,-1448.08,ACH_DEBIT,1576.08
DEBIT,7/2/2020,Online Transfer to SAV ...9797 transaction#: 9881241732 07/02,-1400,ACCT_XFER,3024.16
DEBIT,7/2/2020,Online Payment 9881224595 To ALA 5817 07/02,-432.61,LOAN_PMT,4424.16
CREDIT,7/2/2020,CVO HOLDING COMP DIRECT DEP                 PPD ID: 9111111101,2470.04,ACH_CREDIT,4856.77
DEBIT,7/1/2020,GOOGLE *YouTube Music 855-836-3987 CA        06/30,-10.85,DEBIT_CARD,2386.73
DEBIT,7/1/2020,JEWEL OSCO 0076 CROWN POINT IN       052786  07/01,-29.42,DEBIT_CARD,2397.58
CREDIT,7/1/2020,Online Transfer from SAV ...9797 transaction#: 9872281290,1000,ACCT_XFER,2427
DEBIT,6/30/2020,DISCOVER         E-PAYMENT  2463            WEB ID: 2510020270,-61.7,ACH_DEBIT,1427
DEBIT,6/30/2020,STRACK & VAN TIL #8787 CROWN POINT IN        06/29,-14,DEBIT_CARD,1488.7
DEBIT,6/30/2020,CHIPOTLE 3282 CROWN POINT IN                 06/29,-25.47,DEBIT_CARD,1502.7
DEBIT,6/29/2020,WALGREENS #12812 CROWN POINT IN              06/27,-80.24,DEBIT_CARD,1528.17
CREDIT,6/29/2020,ATM CHECK DEPOSIT 06/28 115 S COURT ST CROWN POINT IN,610,ATM_DEPOSIT,1608.41
DEBIT,6/23/2020,APS electric pmt PAYMENT    3518057919      WEB ID: 1860011170,-53.56,ACH_DEBIT,998.41
DEBIT,6/22/2020,Wal-Mart Super Center MERRILLVILLE IN        06/22,-53.44,DEBIT_CARD,1051.97
DEBIT,6/22/2020,WALGREENS STORE 1520 S CROWN POINT IN107057  06/22,-14.51,DEBIT_CARD,1105.41
DEBIT,6/22/2020,STRACK & VAN TIL #8787 CROWN POINT IN        06/21,-33.39,DEBIT_CARD,1119.92
DEBIT,6/22/2020,CASEYS HEBRON 215 N MA HEBRON IN     664160  06/21,-8.57,DEBIT_CARD,1153.31
DEBIT,6/22/2020,BEST BUY      00009514 VALPARAISO IN         06/21,-106.99,DEBIT_CARD,1161.88
DEBIT,6/22/2020,FAHRENHEIT TWO TWELVE CROWN POINT IN         06/20,-26.39,DEBIT_CARD,1268.87
DEBIT,6/22/2020,FAMILY EXPRESS #66 CROWN POINT IN            06/20,-43.32,DEBIT_CARD,1295.26
DEBIT,6/22/2020,INTERNATIONAL SUBARU MERRILLVILLE IN         06/19,-83.69,DEBIT_CARD,1338.58
DEBIT,6/19/2020,Online Transfer to SAV ...9797 transaction#: 9803609324 06/19,-1000,ACCT_XFER,1422.27
DEBIT,6/19/2020,Online Transfer to SAV ...9797 transaction#: 9803604005 06/19,-1000,ACCT_XFER,2422.27
CREDIT,6/19/2020,CVO HOLDING COMP DIRECT DEP                 PPD ID: 9111111101,2470.05,ACH_CREDIT,3422.27
DEBIT,6/18/2020,Amazon Prime*MS5522L Amzn.com/bill WA        06/18,-14.11,DEBIT_CARD,952.22
DEBIT,6/18/2020,WALGREENS STORE 1520 S CROWN POINT IN464354  06/18,-0.51,DEBIT_CARD,966.33
DEBIT,6/18/2020,FAMILY EXPRESS #65 CROWN POINT IN            06/16,-4.01,DEBIT_CARD,966.84
DEBIT,6/17/2020,SQ *CHEMSHAW 13 DONUTZ Crown Point IN        06/17,-3.75,DEBIT_CARD,970.85
DEBIT,6/16/2020,FAMILY EXPRESS CROWN POINT IN                06/16,-36.2,DEBIT_CARD,974.6
DEBIT,6/15/2020,MCDONALD'S F2919 SHELBYVILLE IN              06/14,-7.12,DEBIT_CARD,1010.8
DEBIT,6/15/2020,CORK LIQUORS X SHELBYVILLE IN                06/13,-27.8,DEBIT_CARD,1017.92
DEBIT,6/15/2020,WAL-MART #0884 SHELBYVILLE IN                06/13,-15.56,DEBIT_CARD,1045.72
DEBIT,6/15/2020,STARBUCKS STORE 13249 SHELBYVILLE IN         06/13,-12.69,DEBIT_CARD,1061.28
DEBIT,6/15/2020,PILOT         00006536 HEBRON IN             06/12,-21.01,DEBIT_CARD,1073.97
DEBIT,6/15/2020,PP*CHEMSHAW13D CROWN POINT IN                06/12,-15.95,DEBIT_CARD,1094.98
CREDIT,6/15/2020,Online Transfer 9761329288 from Fifth Third Checking ######0462 transaction #: 9761329288 06/15,200,ACCT_XFER,1110.93
DEBIT,6/10/2020,HLU*Hulu 16100496516 HULU.COM/BILL CA        06/10,-13.03,DEBIT_CARD,910.93
DEBIT,6/10/2020,UDEMY ONLINE COURSES HTTPSWWW.UDEM CA        06/09,-23.88,DEBIT_CARD,923.96
CREDIT,6/10/2020,VENMO            CASHOUT                    PPD ID: 5264681992,34,ACH_CREDIT,947.84
DEBIT,6/8/2020,VZWRLSS*BILL PAY VN 800-922-0204 FL          06/06,-69.68,DEBIT_CARD,913.84
DEBIT,6/8/2020,JEWEL OSCO 0076 CROWN POINT IN       453153  06/07,-67.03,DEBIT_CARD,983.52
DEBIT,6/8/2020,FAMILY EXPRESS CROWN POINT IN                06/07,-34.6,DEBIT_CARD,1050.55
DEBIT,6/8/2020,CULVERS OF CROWN POINT CROWN POINT IN        06/07,-11.12,DEBIT_CARD,1085.15
DEBIT,6/5/2020,Online Transfer to SAV ...9797 transaction#: 9730531570 06/05,-2000,ACCT_XFER,1096.27
DEBIT,6/5/2020,Online Payment 9730514092 To ALA 5817 06/05,-432.61,LOAN_PMT,3096.27
DEBIT,6/5/2020,SPORT CLIPS - IN605 - CROWN POINT IN         06/04,-27,DEBIT_CARD,3528.88
CREDIT,6/5/2020,CVO HOLDING COMP DIRECT DEP                 PPD ID: 9111111101,2470.06,ACH_CREDIT,3555.88
DEBIT,6/4/2020,PP*CHEMSHAW13D CROWN POINT IN                06/03,-8.96,DEBIT_CARD,1085.82
DEBIT,6/4/2020,REI.COM 800-426-4840 WA                      06/04,-39.33,DEBIT_CARD,1094.78
DEBIT,6/4/2020,AMERICAN AIR00121282763 FORT WORTH TX        06/02,-157.8,DEBIT_CARD,1134.11
DEBIT,6/3/2020,SIP COFFEE HOUSE CROWN POINT IN              06/02,-8.54,DEBIT_CARD,1291.91
DEBIT,6/3/2020,ZODIAC CAFE AND LOUNGE CROWN POINT IN        05/31,-26.4,DEBIT_CARD,1300.45
DEBIT,6/2/2020,WEIDNER-WF-DPTEX WEB PMTS   L6DGX5          WEB ID: 9000200905,-1444.95,ACH_DEBIT,1326.85
DEBIT,6/2/2020,CULVERS OF CROWN POINT CROWN POINT IN        06/01,-14.43,DEBIT_CARD,2771.8
DEBIT,6/2/2020,UDEMY ONLINE COURSES HTTPSWWW.UDEM CA        06/01,-16.28,DEBIT_CARD,2786.23
DEBIT,6/2/2020,DUNKIN #352549 Q35 CROWN POINT IN            06/01,-4.67,DEBIT_CARD,2802.51
CREDIT,6/2/2020,STATEOFMICHIGAN  PMT/REFUND                 PPD ID: 014-INCTAX,14,ACH_CREDIT,2807.18
DEBIT,6/1/2020,GOOGLE*YOUTUBE MUSIC INTERNET CA             05/30,-10.85,DEBIT_CARD,2793.18
DEBIT,6/1/2020,STRACK & VAN TIL #8787 CROWN POINT IN        05/31,-62,DEBIT_CARD,2804.03
DEBIT,6/1/2020,SHELL OIL 12671876006 LAFAYETTE IN           05/30,-9.45,DEBIT_CARD,2866.03
DEBIT,6/1/2020,SPEEDWAY 07373 1 100 E CROWN POINT IN536170  05/30,-28.62,DEBIT_CARD,2875.48
DEBIT,6/1/2020,SIP COFFEE HOUSE CROWN POINT IN              05/31,-11.9,DEBIT_CARD,2904.1
DEBIT,6/1/2020,CVS/PHARMACY #02665 CROWNPOINT IN            05/29,-52.72,DEBIT_CARD,2916
CREDIT,6/1/2020,Online Transfer from SAV ...9797 transaction#: 9700632533,400,ACCT_XFER,2968.72
DEBIT,5/28/2020,Online Transfer to SAV ...9797 transaction#: 9680162014 05/28,-3000,ACCT_XFER,2568.72
CREDIT,5/28/2020,IRS  TREAS 310     TAX REF                  PPD ID: 9111736946,2866,ACH_CREDIT,5568.72
DEBIT,5/27/2020,SEC BACK OFFICE 602-5087550 AZ               05/26,-22.5,DEBIT_CARD,2702.72
DEBIT,5/27/2020,M-46 CITGO HOWARD CITY MI                    05/25,-3.78,DEBIT_CARD,2725.22
DEBIT,5/26/2020,Online Transfer to SAV ...9797 transaction#: 9662071097 05/26,-400,ACCT_XFER,2729
DEBIT,5/26/2020,OLD AU GRAYLING MI                           05/22,-444.59,DEBIT_CARD,3129
CREDIT,5/26/2020,AZ DEPT OF REV   Tax Refund                 PPD ID: 1866004799,341,ACH_CREDIT,3573.59
DEBIT,5/22/2020,Online Transfer to SAV ...9797 transaction#: 9656045743 05/22,-1000,ACCT_XFER,3232.59
DEBIT,5/22/2020,SPEEDWAY 06512 8 859 I HOLLAND MI    128309  05/22,-3.98,DEBIT_CARD,4232.59
CREDIT,5/22/2020,CVO HOLDING COMP DIRECT DEP                 PPD ID: 9111111101,2470.04,ACH_CREDIT,4236.57
DEBIT,5/20/2020,Amazon Prime*M79K71F Amzn.com/bill WA        05/20,-14.11,DEBIT_CARD,1766.53
DEBIT,5/20/2020,TEAMTREEHOUSE.COM 800-928-2130 FL            05/20,-25,DEBIT_CARD,1780.64
DEBIT,5/20/2020,TAVERN ON MAIN CROWN POINT IN                05/19,-15.84,DEBIT_CARD,1805.64
DEBIT,5/19/2020,STRACK & VAN TIL 200 W CROWN POINT IN215529  05/19,-34.28,DEBIT_CARD,1821.48
DEBIT,5/18/2020,STRACK & VAN TIL 200 W CROWN POINT IN541636  05/16,-23.03,DEBIT_CARD,1855.76
DEBIT,5/18/2020,FAMILY EXPRESS #66 CROWN POINT IN            05/16,-28.36,DEBIT_CARD,1878.79
DEBIT,5/18/2020,LUCREZIA RISTORANTE CROWN POINT IN           05/15,-44.72,DEBIT_CARD,1907.15
DEBIT,5/18/2020,FAHRENHEIT TWO TWELVE CROWN POINT IN         05/14,-30.79,DEBIT_CARD,1951.87
DEBIT,5/12/2020,APS electric pmt PAYMENT    3518057919      WEB ID: 1860011170,-42.46,ACH_DEBIT,1982.66
DEBIT,5/11/2020,HLU*Hulu 16100496588 HULU.COM/BILL CA        05/10,-13.03,DEBIT_CARD,2025.12
DEBIT,5/11/2020,VZWRLSS*BILL PAY VN 800-922-0204 FL          05/09,-77.48,DEBIT_CARD,2038.15
DEBIT,5/11/2020,VZWRLSS*BILL PAY VN 800-922-0204 FL          05/09,-132.92,DEBIT_CARD,2115.63
DEBIT,5/11/2020,APPLE.COM/BILL 866-712-7753 CA               05/11,-1.08,DEBIT_CARD,2248.55
DSLIP,5/11/2020,REMOTE ONLINE DEPOSIT #          1,24,CHECK_DEPOSIT,2249.63
DSLIP,5/11/2020,REMOTE ONLINE DEPOSIT #          1,165,CHECK_DEPOSIT,2225.63
DEBIT,5/8/2020,Online Transfer to SAV ...9797 transaction#: 9578931738 05/08,-1000,ACCT_XFER,2060.63
DEBIT,5/8/2020,Online Payment 9578896989 To ALA 5817 05/08,-432.61,LOAN_PMT,3060.63
CREDIT,5/8/2020,CVO HOLDING COMP DIRECT DEP                 PPD ID: 9111111101,2470.06,ACH_CREDIT,3493.24
DEBIT,5/4/2020,WEIDNER-WF-DPTEX WEB PMTS   5KH6S5          WEB ID: 9000200905,-1450.29,ACH_DEBIT,1023.18
DEBIT,5/1/2020,GOOGLE *YouTube Music 855-836-3987 CA        04/30,-10.85,DEBIT_CARD,2473.47
DEBIT,5/1/2020,UDEMY ONLINE COURSES HTTPSWWW.UDEM CA        04/30,-39.07,DEBIT_CARD,2484.32
DEBIT,4/27/2020,TWIN LAKES FISH AND GA MONTICELLO IN 247861  04/26,-158.85,DEBIT_CARD,2523.39
DEBIT,4/27/2020,USPS CHANGE OF ADDRES 800-238-3150 TN        04/25,-1.05,DEBIT_CARD,2682.24
DEBIT,4/24/2020,Online Transfer to SAV ...9797 transaction#: 9500243859 04/24,-1000,ACCT_XFER,2683.29
CREDIT,4/24/2020,CVO HOLDING COMP DIRECT DEP                 PPD ID: 9111111101,2470.04,ACH_CREDIT,3683.29
DEBIT,4/20/2020,TEAMTREEHOUSE.COM 800-928-2130 OR            04/20,-25,DEBIT_CARD,1213.25
DEBIT,4/16/2020,SPEEDWAY 07373 1 100 E CROWN POINT IN204894  04/16,-28.8,DEBIT_CARD,1238.25
DEBIT,4/14/2020,APS electric pmt PAYMENT    3518057919      WEB ID: 1860011170,-67.57,ACH_DEBIT,1267.05
DEBIT,4/13/2020,VZWRLSS*BILL PAY VN 800-922-0204 FL          04/11,-132.57,DEBIT_CARD,1334.62
DEBIT,4/10/2020,HLU*Hulu 16100496521 HULU.COM/BILL CA        04/10,-13.03,DEBIT_CARD,1467.19
DEBIT,4/10/2020,Online Transfer to SAV ...9797 transaction#: 9429269316 04/10,-1500,ACCT_XFER,1480.22
DEBIT,4/10/2020,Online Payment 9429205186 To ALA 5817 04/10,-432.61,LOAN_PMT,2980.22
DEBIT,4/10/2020,FAHRENHEIT TWO TWELVE CROWN POINT IN         04/08,-62.88,DEBIT_CARD,3412.83
CREDIT,4/10/2020,CVO HOLDING COMP DIRECT DEP                 PPD ID: 9111111101,2470.06,ACH_CREDIT,3475.71
DEBIT,4/9/2020,NINTENDO    *AMERICAU 800-255-3700 WA        04/09,-21.57,DEBIT_CARD,1005.65
DEBIT,4/6/2020,CARRIAGE COURT PIZZA CROWN POINT IN          04/03,-48.71,DEBIT_CARD,1027.22
DEBIT,4/2/2020,WEIDNER-WF-DPTEX WEB PMTS   TMFWM5          WEB ID: 9000200905,-1438.06,ACH_DEBIT,1075.93
DEBIT,4/2/2020,ARDUINO STORE HTTPSSTORE.AR MA               04/01,-113.49,DEBIT_CARD,2513.99
DEBIT,3/31/2020,GOOGLE*YOUTUBE MUSIC INTERNET CA             03/30,-10.85,DEBIT_CARD,2627.48
DEBIT,3/27/2020,Online Transfer to SAV ...9797 transaction#: 9358992208 03/27,-1000,ACCT_XFER,2638.33
CREDIT,3/27/2020,CVO HOLDING COMP DIRECT DEP                 PPD ID: 9111111101,2470.05,ACH_CREDIT,3638.33
DEBIT,3/26/2020,BUCKS BICYCLE SHOP INC VALPARAISO IN         03/25,-42.75,DEBIT_CARD,1168.28
DEBIT,3/24/2020,APS electric pmt PAYMENT    3518057919      WEB ID: 1860011170,-119.44,ACH_DEBIT,1211.03
DEBIT,3/23/2020,NON-CHASE ATM FEE-WITH,-2.5,FEE_TRANSACTION,1330.47
DEBIT,3/23/2020,PHILLIPS 66 - PHILLIPS EUREKA MO             03/21,-27.61,DEBIT_CARD,1332.97
DEBIT,3/23/2020,PHILLIPS 66 EURE EUREKA MO           761189  03/21,-6.01,DEBIT_CARD,1360.58
DEBIT,3/23/2020,QT 41 TULSA OK                               03/21,-13.77,DEBIT_CARD,1366.59
DEBIT,3/23/2020,NON-CHASE ATM WITHDRAW               759491  03/215300 NE 1,-43,ATM,1380.36
DEBIT,3/23/2020,7 ELEVEN 27 DEL CITY OK              615204  03/21,-2.17,DEBIT_CARD,1423.36
DEBIT,3/23/2020,SHELL SERVICE S CANUTE OK                    03/21,-11.72,DEBIT_CARD,1425.53
DEBIT,3/23/2020,SHELL SERVICE S CANUTE OK                    03/21,-2.2,DEBIT_CARD,1437.25
DEBIT,3/23/2020,STORE 2006 SHAMROCK TX                       03/21,-2.09,DEBIT_CARD,1439.45
DEBIT,3/23/2020,TOOT #78 N TOTUM AMARILLO TX         070251  03/21,-16.95,DEBIT_CARD,1441.54
DEBIT,3/23/2020,ALLSUPS #0291 2252 ROU SANTA ROSA NM 257172  03/21,-6.58,DEBIT_CARD,1458.49
DEBIT,3/23/2020,PHILLIPS 66 - MR GAS 13 EDGEWOOD NM          03/21,-26.66,DEBIT_CARD,1465.07
DEBIT,3/20/2020,SPEEDWAY 02951 9 910 S PAYSON AZ     819969  03/20,-26.62,DEBIT_CARD,1491.73
DEBIT,3/20/2020,TEAMTREEHOUSE.COM 800-928-2130 FL            03/20,-25,DEBIT_CARD,1518.35
CREDIT,3/19/2020,VENMO            CASHOUT                    PPD ID: 5264681992,55,ACH_CREDIT,1543.35
DEBIT,3/18/2020,Amazon Prime*JC7J06E Amzn.com/bill WA        03/18,-14.11,DEBIT_CARD,1488.35
DEBIT,3/18/2020,USCONNECT ACEVN VEND  N TEMPE AZ             03/18,-1,DEBIT_CARD,1502.46
DEBIT,3/17/2020,USCONNECT ACEVN VEND  N TEMPE AZ             03/16,-1,DEBIT_CARD,1503.46
DEBIT,3/17/2020,USCONNECT ACEVN VEND  N TEMPE AZ             03/16,-1,DEBIT_CARD,1504.46
DEBIT,3/16/2020,DISCOVER         E-PAYMENT  2463            WEB ID: 2510020270,-67.12,ACH_DEBIT,1505.46
DEBIT,3/16/2020,VZWRLSS*BILL PAY VN 800-922-0204 FL          03/14,-132.57,DEBIT_CARD,1572.58
DEBIT,3/16/2020,CVS/PHARMACY #08366 PHOENIX AZ               03/15,-61.54,DEBIT_CARD,1705.15
DEBIT,3/16/2020,TRADER JOE'S #090  QPS PHOENIX AZ            03/15,-56.09,DEBIT_CARD,1766.69
DEBIT,3/16/2020,TARGET        00032615 PHOENIX AZ            03/15,-64.85,DEBIT_CARD,1822.78
DEBIT,3/16/2020,CULINARY DROPOUT SCOTTSDALE AZ               03/14,-12.94,DEBIT_CARD,1887.63
DEBIT,3/16/2020,USCONNECT ACEVN VEND  N TEMPE AZ             03/15,-1,DEBIT_CARD,1900.57
DEBIT,3/13/2020,Online Payment 9296315832 To ALA 5817 03/13,-432.61,LOAN_PMT,1901.57
DEBIT,3/13/2020,Online Transfer to SAV ...9797 transaction#: 9296306687 03/13,-1000,ACCT_XFER,2334.18
DEBIT,3/13/2020,TARGET        00032615 PHOENIX AZ            03/12,-22.68,DEBIT_CARD,3334.18
DEBIT,3/13/2020,FRY'S FOOD DRG 129 PHOENIX AZ                03/12,-62.27,DEBIT_CARD,3356.86
CREDIT,3/13/2020,CVO HOLDING COMP DIRECT DEP                 PPD ID: 9111111101,2470.05,ACH_CREDIT,3419.13
DEBIT,3/12/2020,TFK OLO #1001 olo.com AZ                     03/12,-45.81,DEBIT_CARD,949.08
DEBIT,3/12/2020,USCONNECT ACEVN VEND  N TEMPE AZ             03/12,-1,DEBIT_CARD,994.89
DEBIT,3/12/2020,USCONNECT ACEVN VEND  N TEMPE AZ             03/12,-1,DEBIT_CARD,995.89
DEBIT,3/12/2020,TARGET        00032615 PHOENIX AZ            03/11,-28.77,DEBIT_CARD,996.89
DEBIT,3/12/2020,FRY'S FOOD DRG 129 PHOENIX AZ                03/10,-26.5,DEBIT_CARD,1025.66
DEBIT,3/12/2020,AMZN Mktp US*8706I61 Amzn.com/bill WA        03/12,-299.71,DEBIT_CARD,1052.16
DEBIT,3/12/2020,Steamgames.com42595229 425-9522985 WA        03/12,-43.43,DEBIT_CARD,1351.87
DEBIT,3/11/2020,Amazon Prime*JR3ZG02 Amzn.com/bill WA        03/11,-2.16,DEBIT_CARD,1395.3
DEBIT,3/11/2020,BEST BUY #253 PHOENIX AZ             340758  03/11,-10.85,DEBIT_CARD,1397.46
DEBIT,3/11/2020,ARCO #42554 AMPM PHOENIX AZ                  03/11,-45.56,DEBIT_CARD,1408.31
DEBIT,3/11/2020,AMZN Mktp US*BY0TT8J Amzn.com/bill WA        03/11,-145.49,DEBIT_CARD,1453.87
DEBIT,3/11/2020,USCONNECT ACEVN VEND  N TEMPE AZ             03/11,-1,DEBIT_CARD,1599.36
DEBIT,3/11/2020,FRY'S FOOD DRG 088 PHOENIX AZ                03/10,-6.53,DEBIT_CARD,1600.36
DEBIT,3/11/2020,STARBUCKS STORE 05534 PHOENIX AZ             03/10,-2.33,DEBIT_CARD,1606.89
DEBIT,3/10/2020,HLU*Hulu 16100496574 HULU.COM/BILL CA        03/10,-13.03,DEBIT_CARD,1609.22
DEBIT,3/10/2020,FRY'S FOOD DRG 088 PHOENIX AZ                03/09,-7.3,DEBIT_CARD,1622.25
DEBIT,3/10/2020,SPOONZ CAFE PHOENIX AZ                       03/09,-2.77,DEBIT_CARD,1629.55
DEBIT,3/10/2020,LUCI'SHEALTHYMARKETPLAC PHOENIX AZ           03/09,-42.37,DEBIT_CARD,1632.32
CREDIT,3/10/2020,Online Transfer from SAV ...9797 transaction#: 9286593233,500,ACCT_XFER,1674.69
DEBIT,3/9/2020,USCONNECT ACEVN VEND  N TEMPE AZ             03/08,-1,DEBIT_CARD,1174.69
DEBIT,3/9/2020,USCONNECT ACEVN VEND  N TEMPE AZ             03/08,-1,DEBIT_CARD,1175.69
DEBIT,3/9/2020,PF CHANGS #9978 SCOTTSDALE AZ                03/07,-7.48,DEBIT_CARD,1176.69
DEBIT,3/9/2020,BARRIO QUEEN - SCOTTSDA SCOTTSDALE AZ        03/07,-30.93,DEBIT_CARD,1184.17
DEBIT,3/9/2020,USCONNECT ACEVN VEND  N TEMPE AZ             03/07,-1,DEBIT_CARD,1215.1
CREDIT,3/9/2020,Online Transfer 9266038212 from Fifth Third Checking ######0462 transaction #: 9266038212 03/09,200,ACCT_XFER,1216.1
CREDIT,3/9/2020,ATM CHECK DEPOSIT 03/07 5041 N 16TH ST PHOENIX AZ,200,ATM_DEPOSIT,1016.1
DEBIT,3/6/2020,UDEMY ONLINE COURSES HTTPSWWW.UDEM CA        03/05,-10.99,DEBIT_CARD,816.1
DEBIT,3/6/2020,TRUE FOOD KITCHEN #1001 PHOENIX AZ           03/04,-42.3,DEBIT_CARD,827.09
DEBIT,3/6/2020,LUCI'SHEALTHYMARKETPLAC PHOENIX AZ           03/05,-29.87,DEBIT_CARD,869.39
DEBIT,3/5/2020,FRY'S FOOD DRG 129 PHOENIX AZ                03/04,-12.98,DEBIT_CARD,899.26
DEBIT,3/4/2020,CHEVRON 0308116 SEDONA AZ                    03/03,-1.99,DEBIT_CARD,912.24
DEBIT,3/4/2020,PICAZZO'S ORGANIC ITAL SEDONA AZ             03/03,-50.47,DEBIT_CARD,914.23
DEBIT,3/4/2020,RED ROCKS PARKING SEDONA AZ                  03/03,-5,DEBIT_CARD,964.7
DEBIT,3/4/2020,SAFEWAY #1207 SEDONA AZ                      03/03,-7.03,DEBIT_CARD,969.7
DEBIT,3/3/2020,WEIDNER-WF-DPTEX WEB PMTS   TQ29J5          WEB ID: 9000200905,-1000,ACH_DEBIT,976.73
DEBIT,3/3/2020,GRIMALDI'S PIZZA #01101 SCOTTSDALE AZ        03/02,-20.21,DEBIT_CARD,1976.73
DEBIT,3/2/2020,GOOGLE*YOUTUBE MUSIC INTERNET CA             02/29,-10.85,DEBIT_CARD,1996.94
DEBIT,3/2/2020,FRY'S FOOD DRG 129 PHOENIX AZ                02/29,-5.99,DEBIT_CARD,2007.79
DEBIT,3/2/2020,POSTINO CENTRAL PHOENIX AZ                   02/29,-20.37,DEBIT_CARD,2013.78
DEBIT,3/2/2020,REI #56 PARADISE VAL 1 PHOENIX AZ            02/29,-155.03,DEBIT_CARD,2034.15
DEBIT,3/2/2020,USERY MOUNTAIN REGIONAL MESA AZ              03/01,-7,DEBIT_CARD,2189.18
DEBIT,3/2/2020,TORTILLA FLAT - MAIN TORTILLA FLAT AZ        03/01,-8.75,DEBIT_CARD,2196.18
DEBIT,3/2/2020,TARGET        00002337 PHOENIX AZ            03/01,-8.97,DEBIT_CARD,2204.93
DEBIT,3/2/2020,REI #56 PARADISE VAL 1 PHOENIX AZ            03/01,-42.03,DEBIT_CARD,2213.9
DEBIT,3/2/2020,LUCI'SHEALTHYMARKETPLAC PHOENIX AZ           02/29,-23.61,DEBIT_CARD,2255.93
CREDIT,3/2/2020,VENMO            CASHOUT                    PPD ID: 5264681992,100,ACH_CREDIT,2279.54
DEBIT,2/28/2020,AT HOME #95 PHOENIX AZ                       02/28,-217.19,DEBIT_CARD,2179.54
DEBIT,2/28/2020,Online Transfer to SAV ...9797 transaction#: 9238911681 02/28,-1000,ACCT_XFER,2396.73
DEBIT,2/28/2020,A EAGLE OUTFTR00006288 SCOTTSDALE AZ         02/27,-96.61,DEBIT_CARD,3396.73
DEBIT,2/28/2020,FRY'S FOOD DRG 088 PHOENIX AZ                02/27,-6.85,DEBIT_CARD,3493.34
CREDIT,2/28/2020,CVO HOLDING COMP DIRECT DEP                 PPD ID: 9111111101,2470.05,ACH_CREDIT,3500.19
DEBIT,2/27/2020,DISCOVER         E-PAYMENT  2463            WEB ID: 2510020270,-65.15,ACH_DEBIT,1030.14
DEBIT,2/27/2020,CHIPOTLE 1684 PHOENIX AZ                     02/26,-7.76,DEBIT_CARD,1095.29
DEBIT,2/26/2020,FRY'S FOOD DRG 088 PHOENIX AZ                02/25,-5.87,DEBIT_CARD,1103.05
CREDIT,2/26/2020,Online Transfer 9223254598 from Fifth Third Checking ######0462 transaction #: 9223254598 02/26,200,ACCT_XFER,1108.92
DEBIT,2/25/2020,FRY'S FOOD DRG 088 PHOENIX AZ                02/24,-5.68,DEBIT_CARD,908.92
DEBIT,2/25/2020,LUCI'S AT THE ORCHARD PHOENIX AZ             02/24,-37.04,DEBIT_CARD,914.6
DEBIT,2/24/2020,SHELL SERVICE S PHOENIX AZ                   02/24,-48.56,DEBIT_CARD,951.64
DEBIT,2/24/2020,FRY'S MKTPLACE 612 PHOENIX AZ                02/23,-43.82,DEBIT_CARD,1000.2
DEBIT,2/24/2020,OHSO BREWERY PV PHOENIX AZ                   02/24,-40.67,DEBIT_CARD,1044.02
DEBIT,2/24/2020,FRY'S FOOD DRG 129 PHOENIX AZ                02/22,-10.98,DEBIT_CARD,1084.69
DEBIT,2/24/2020,TRUE FOOD KITCHEN #1001 PHOENIX AZ           02/22,-19.94,DEBIT_CARD,1095.67
DEBIT,2/24/2020,7619 Dominos Pizza 734-930-3030 AZ           02/21,-13.01,DEBIT_CARD,1115.61
DEBIT,2/24/2020,FRY'S FOOD DRG 088 PHOENIX AZ                02/21,-5.97,DEBIT_CARD,1128.62
DEBIT,2/21/2020,SPORT CLIPS - AZ141 - P PHOENIX AZ           02/20,-28,DEBIT_CARD,1134.59
DEBIT,2/21/2020,FRY'S FOOD DRG 088 PHOENIX AZ                02/20,-14.77,DEBIT_CARD,1162.59
DEBIT,2/20/2020,TEAMTREEHOUSE.COM 800-928-2130 FL            02/20,-25,DEBIT_CARD,1177.36
DEBIT,2/20/2020,TARGET        00032615 PHOENIX AZ            02/19,-5.99,DEBIT_CARD,1202.36
DEBIT,2/19/2020,APS electric pmt PAYMENT    3518057919      WEB ID: 1860011170,-110.66,ACH_DEBIT,1208.35
CREDIT,2/19/2020,VENMO            CASHOUT                    PPD ID: 5264681992,90,ACH_CREDIT,1319.01
DEBIT,2/18/2020,VZWRLSS*APOCC VISN 800-922-0204 FL           02/15,-132.57,DEBIT_CARD,1229.01
DEBIT,2/18/2020,DISCOVER         E-PAYMENT  2463            WEB ID: 2510020270,-141.18,ACH_DEBIT,1361.58
DEBIT,2/18/2020,REI #56 PARADISE VAL 1 PHOENIX AZ            02/18,-18,DEBIT_CARD,1502.76
DEBIT,2/18/2020,TARGET        00032615 PHOENIX AZ            02/17,-4.89,DEBIT_CARD,1520.76
DEBIT,2/18/2020,FRY'S FOOD DRG 129 PHOENIX AZ                02/17,-70.52,DEBIT_CARD,1525.65
DEBIT,2/18/2020,FRY'S FOOD DRG 088 PHOENIX AZ                02/17,-7.48,DEBIT_CARD,1596.17
DEBIT,2/18/2020,FRY'S FOOD DRG 129 PHOENIX AZ                02/16,-32.93,DEBIT_CARD,1603.65
DEBIT,2/18/2020,IKEA TEMPE TEMPE AZ                  794854  02/16,-269.17,DEBIT_CARD,1636.58
DEBIT,2/18/2020,ARCO #42878 AMPM SEDONA AZ                   02/15,-4,DEBIT_CARD,1905.75
DEBIT,2/18/2020,THE HUDSON SEDONA AZ                         02/15,-26.91,DEBIT_CARD,1909.75
DEBIT,2/18/2020,PINK JEEP TOURS INC 9282829000 AZ            02/15,-35,DEBIT_CARD,1936.66
DEBIT,2/18/2020,CVS/PHARMACY #09297 PHOENIX AZ               02/15,-16,DEBIT_CARD,1971.66
DEBIT,2/18/2020,POMO DOWNTOWN PHOENIX AZ                     02/14,-71.52,DEBIT_CARD,1987.66
DEBIT,2/18/2020,PARKMOBILE 770-818-9036 AZ                   02/15,-6.35,DEBIT_CARD,2059.18
DEBIT,2/18/2020,KT VAL GAS STATION PHOENIX AZ                02/14,-50.77,DEBIT_CARD,2065.53
DEBIT,2/18/2020,LUCI'SHEALTHYMARKETPLAC PHOENIX AZ           02/15,-5.23,DEBIT_CARD,2116.3
DEBIT,2/18/2020,LUCI'SHEALTHYMARKETPLAC PHOENIX AZ           02/15,-19.93,DEBIT_CARD,2121.53
DEBIT,2/18/2020,PINK JEEP TOURS INC 9282829000 AZ            02/13,-166.6,DEBIT_CARD,2141.46
CREDIT,2/18/2020,VENMO            CASHOUT                    PPD ID: 5264681992,75,ACH_CREDIT,2308.06
DEBIT,2/14/2020,Online Transfer to SAV ...9797 transaction#: 9187910395 02/14,-1000,ACCT_XFER,2233.06
DEBIT,2/14/2020,Online Payment 9187905694 To ALA 5817 02/14,-432.61,LOAN_PMT,3233.06
DEBIT,2/14/2020,WHOLEFDS CMA #10476 PHOENIX AZ               02/13,-25.09,DEBIT_CARD,3665.67
DEBIT,2/14/2020,HALAL GUYS - CHRIS TOWN PHOENIX AZ           02/12,-9.77,DEBIT_CARD,3690.76
CREDIT,2/14/2020,CVO HOLDING COMP DIRECT DEP                 PPD ID: 9111111101,2585.75,ACH_CREDIT,3700.53
DEBIT,2/13/2020,GCU STUDENT UNION PHOENIX AZ                 02/12,-2.44,DEBIT_CARD,1114.78
DEBIT,2/11/2020,FRY'S FOOD DRG 129 PHOENIX AZ                02/10,-16.56,DEBIT_CARD,1117.22
DEBIT,2/11/2020,FRY'S FOOD DRG 088 PHOENIX AZ                02/10,-5.53,DEBIT_CARD,1133.78
DEBIT,2/11/2020,LUCI'SHEALTHYMARKETPLAC PHOENIX AZ           02/10,-16.58,DEBIT_CARD,1139.31
DEBIT,2/10/2020,HLU*Hulu 16100496573 HULU.COM/BILL CA        02/10,-13.03,DEBIT_CARD,1155.89
DEBIT,2/10/2020,WHOLEFDS CMA #10476 PHOENIX AZ               02/09,-33.38,DEBIT_CARD,1168.92
DEBIT,2/10/2020,FRY'S FOOD DRG 129 PHOENIX AZ                02/09,-40.33,DEBIT_CARD,1202.3
DEBIT,2/10/2020,SPEEDWAY 02951 910 S. B PAYSON AZ            02/08,-10.97,DEBIT_CARD,1242.63
DEBIT,2/10/2020,CULINARY DROPOUT SCOTTSDALE AZ               02/07,-18.12,DEBIT_CARD,1253.6
CREDIT,2/10/2020,VENMO            CASHOUT                    PPD ID: 5264681992,20,ACH_CREDIT,1271.72
DEBIT,2/7/2020,TARGET        00032615 PHOENIX AZ            02/06,-111.79,DEBIT_CARD,1251.72
DEBIT,2/7/2020,Dignity AZ Hosp PayNow 972-8996666 TX        02/06,-100,DEBIT_CARD,1363.51
DEBIT,2/7/2020,TARGET        00032615 PHOENIX AZ            02/06,32.56,DEBIT_CARD,1463.51
DEBIT,2/6/2020,ARCO #42554 AMPM PHOENIX AZ          782456  02/06,-46.58,DEBIT_CARD,1430.95
DEBIT,2/4/2020,WEIDNER-WF-DPTEX WEB PMTS   5WKMD5          WEB ID: 9000200905,-1000,ACH_DEBIT,1477.53
DEBIT,2/4/2020,TARGET        00032615 PHOENIX AZ            02/03,-8.98,DEBIT_CARD,2477.53
DEBIT,2/4/2020,SCHOOL FUNDRAISER 714-612-5434 CA            02/04,-20,DEBIT_CARD,2486.51
DEBIT,2/3/2020,FRY'S FOOD DRG 129 PHOENIX AZ                02/02,-32.55,DEBIT_CARD,2506.51
DEBIT,2/3/2020,WHOLEFDS CMA #10 4701 PHOENIX AZ     948717  02/02,-18.91,DEBIT_CARD,2539.06
DEBIT,2/3/2020,STARBUCKS STORE 27594 PHOENIX AZ             02/02,-6.62,DEBIT_CARD,2557.97
DEBIT,2/3/2020,CHEVRON/VILLAGE CHEVRO SEDONA AZ     003324  02/01,-29.88,DEBIT_CARD,2564.59
DEBIT,2/3/2020,WEST FORK SEDONA AZ                          02/01,-11,DEBIT_CARD,2594.47
DEBIT,2/3/2020,AZ GAME & FISH DEPT 602-942-3000 AZ          02/02,-37,DEBIT_CARD,2605.47
DEBIT,2/3/2020,TARGET        00032615 PHOENIX AZ            01/31,-24.03,DEBIT_CARD,2642.47
DEBIT,2/3/2020,THE ORVIS CO #699 PHOENIX AZ                 01/31,-215.03,DEBIT_CARD,2666.5
DEBIT,2/3/2020,LUCI'SHEALTHYMARKETPLAC PHOENIX AZ           02/01,-17.1,DEBIT_CARD,2881.53
DEBIT,1/31/2020,GOOGLE *YouTube Music 855-836-3987 CA        01/30,-10.85,DEBIT_CARD,2898.63
DEBIT,1/31/2020,IN *DESERT SPORTSMAN PARADISE VALL AZ587163  01/31,-28.13,DEBIT_CARD,2909.48
DEBIT,1/31/2020,Online Transfer to SAV ...9797 transaction#: 9135925151 01/31,-500,ACCT_XFER,2937.61
DEBIT,1/31/2020,GRIMALDI'S PIZZA #01101 SCOTTSDALE AZ        01/30,-32.42,DEBIT_CARD,3437.61
DEBIT,1/31/2020,FRY'S FOOD DRG 088 PHOENIX AZ                01/30,-2.99,DEBIT_CARD,3470.03
DEBIT,1/31/2020,SPOONZ CAFE PHOENIX AZ                       01/30,-5.97,DEBIT_CARD,3473.02
CREDIT,1/31/2020,CVO HOLDING COMP DIRECT DEP                 PPD ID: 9111111101,2442.09,ACH_CREDIT,3478.99
DEBIT,1/30/2020,FRY'S FOOD DRG 088 PHOENIX AZ                01/29,-9.97,DEBIT_CARD,1036.9
DEBIT,1/30/2020,SEC FRONT OFFICE TEMPE AZ                    01/29,-150,DEBIT_CARD,1046.87
DEBIT,1/30/2020,A. WILLIAM CHOULES DDS PHOENIX AZ            01/29,-10,DEBIT_CARD,1196.87
CREDIT,1/30/2020,Online Transfer 9123171765 from Fifth Third Checking ######0462 transaction #: 9123171765 01/30,300,ACCT_XFER,1206.87
DEBIT,1/29/2020,DISCOVER         E-PAYMENT  2463            WEB ID: 2510020270,-19.71,ACH_DEBIT,906.87
DEBIT,1/29/2020,TARGET        00002337 PHOENIX AZ            01/28,-19.06,DEBIT_CARD,926.58
DEBIT,1/29/2020,CVS/PHARMACY #08914 PHOENIX AZ               01/28,-2.89,DEBIT_CARD,945.64
DEBIT,1/29/2020,FRY'S FOOD DRG 088 PHOENIX AZ                01/28,-6.16,DEBIT_CARD,948.53
DEBIT,1/29/2020,LUCI'SHEALTHYMARKETPLAC PHOENIX AZ           01/28,-16.25,DEBIT_CARD,954.69
DEBIT,1/28/2020,PV CAR WASH PHOENIX AZ                       01/28,-30,DEBIT_CARD,970.94
DEBIT,1/28/2020,REI #56 PARADISE VAL 1 PHOENIX AZ            01/28,-17.86,DEBIT_CARD,1000.94
DEBIT,1/28/2020,USCONNECT ACEVN VEND  N TEMPE AZ             01/28,-1,DEBIT_CARD,1018.8
DEBIT,1/28/2020,LUCI'SHEALTHYMARKETPLAC PHOENIX AZ           01/27,-24.61,DEBIT_CARD,1019.8
CREDIT,1/28/2020,Online Transfer from SAV ...9797 transaction#: 9123165188,280,ACCT_XFER,1044.41
DEBIT,1/27/2020,USCONNECT ACEVN VEND  N TEMPE AZ             01/27,-1,DEBIT_CARD,764.41
DEBIT,1/27/2020,HALF PRICE BOOKS #072 PHOENIX AZ             01/26,-11.92,DEBIT_CARD,765.41
DEBIT,1/27/2020,REI #56 PARADISE VAL 1 PHOENIX AZ            01/26,-96.65,DEBIT_CARD,777.33
DEBIT,1/27/2020,0099 AMC ESPLANDE 14 PHOENIX AZ              01/26,-18.72,DEBIT_CARD,873.98
DEBIT,1/27/2020,TRUE FOOD KITCHEN #1001 PHOENIX AZ           01/25,-21.17,DEBIT_CARD,892.7
DEBIT,1/27/2020,REI #56 PARADISE VAL 1 PHOENIX AZ            01/25,-96.65,DEBIT_CARD,913.87
DEBIT,1/27/2020,FRY'S FOOD DRG 129 PHOENIX AZ                01/24,-15.66,DEBIT_CARD,1010.52
DEBIT,1/27/2020,STARBUCKS STORE 05534 PHOENIX AZ             01/24,-2.88,DEBIT_CARD,1026.18
DEBIT,1/27/2020,CVS/PHARMACY #08914 PHOENIX AZ               01/24,-1,DEBIT_CARD,1029.06
DEBIT,1/23/2020,FRY'S FOOD DRG 129 PHOENIX AZ                01/22,-30.17,DEBIT_CARD,1030.06
DEBIT,1/22/2020,APS electric pmt PAYMENT    3518057919      WEB ID: 1860011170,-89.54,ACH_DEBIT,1060.23
DEBIT,1/22/2020,CHIPOTLE 1684 PHOENIX AZ                     01/21,-7.76,DEBIT_CARD,1149.77
CREDIT,1/22/2020,VENMO            CASHOUT                    PPD ID: 5264681992,44,ACH_CREDIT,1157.53
DEBIT,1/21/2020,SQ *PRESS AT THE MUSE Phoenix AZ             01/20,-3.98,DEBIT_CARD,1113.53
DEBIT,1/21/2020,TARGET        00032615 PHOENIX AZ            01/20,-16.55,DEBIT_CARD,1117.51
DEBIT,1/21/2020,HAMPTON INNS TUCSON AZ                       01/19,-271.8,DEBIT_CARD,1134.06
DEBIT,1/21/2020,TUCSON EAST (HOTEL) TUCSON AZ                01/18,-238.99,DEBIT_CARD,1405.86
DEBIT,1/21/2020,UOFA PARKING WPOS TUCSON AZ                  01/17,-5,DEBIT_CARD,1644.85
DEBIT,1/21/2020,SHELL OIL 10082734004 SUN LAKES AZ           01/17,-48,DEBIT_CARD,1649.85
DEBIT,1/21/2020,LUCI'SHEALTHYMARKETPLAC PHOENIX AZ           01/18,-2.19,DEBIT_CARD,1697.85
CREDIT,1/21/2020,Online Transfer from SAV ...9797 transaction#: 9093554413,300,ACCT_XFER,1700.04
DEBIT,1/17/2020,Online Transfer to SAV ...9797 transaction#: 9086505972 01/17,-480,ACCT_XFER,1400.04
DEBIT,1/17/2020,Online Payment 9086499795 To ALA 5817 01/17,-432.61,LOAN_PMT,1880.04
DEBIT,1/17/2020,USCONNECT ACEVN VEND  N TEMPE AZ             01/16,-1,DEBIT_CARD,2312.65
DEBIT,1/17/2020,USCONNECT ACEVN VEND  N TEMPE AZ             01/16,-1,DEBIT_CARD,2313.65
CREDIT,1/17/2020,CVO HOLDING COMP DIRECT DEP                 PPD ID: 9111111101,1388.93,ACH_CREDIT,2314.65
DEBIT,1/16/2020,TARGET        00032615 PHOENIX AZ            01/15,-20.87,DEBIT_CARD,925.72
DEBIT,1/16/2020,SPOONZ CAFE PHOENIX AZ                       01/15,-3.53,DEBIT_CARD,946.59
DEBIT,1/16/2020,FRY'S FOOD DRG 088 PHOENIX AZ                01/15,-12.68,DEBIT_CARD,950.12
CREDIT,1/16/2020,Online Transfer from SAV ...9797 transaction#: 9085046309,25,ACCT_XFER,962.8
DEBIT,1/15/2020,CHIPOTLE 1684 PHOENIX AZ                     01/14,-7.76,DEBIT_CARD,937.8
DEBIT,1/15/2020,STARBUCKS STORE 05534 PHOENIX AZ             01/14,-2.33,DEBIT_CARD,945.56
CREDIT,1/15/2020,VENMO            CASHOUT                    PPD ID: 5264681992,25,ACH_CREDIT,947.89
DEBIT,1/14/2020,CVS/PHARMACY #08914 PHOENIX AZ               01/13,-7.46,DEBIT_CARD,922.89
DEBIT,1/13/2020,FRY'S FOOD DRG 129 PHOENIX AZ                01/12,-51.18,DEBIT_CARD,930.35
DEBIT,1/13/2020,USCONNECT ACEVN VEND  N TEMPE AZ             01/12,-1,DEBIT_CARD,981.53
DEBIT,1/13/2020,USCONNECT ACEVN VEND  N TEMPE AZ             01/12,-1,DEBIT_CARD,982.53
DEBIT,1/13/2020,7619 Dominos Pizza 734-930-3030 AZ           01/11,-22.24,DEBIT_CARD,983.53
DEBIT,1/13/2020,LUCI'SHEALTHYMARKETPLAC PHOENIX AZ           01/12,-4.52,DEBIT_CARD,1005.77
DEBIT,1/13/2020,LUCI'SHEALTHYMARKETPLAC PHOENIX AZ           01/12,-16.25,DEBIT_CARD,1010.29
DEBIT,1/13/2020,CULINARY DROPOUT SCOTTSDALE AZ               01/10,-23.45,DEBIT_CARD,1026.54
DEBIT,1/13/2020,TARGET        00032615 PHOENIX AZ            01/10,-37.14,DEBIT_CARD,1049.99
DEBIT,1/10/2020,SUN CYCLERY PHOENIX AZ                       01/09,-124.85,DEBIT_CARD,1087.13
DEBIT,1/10/2020,FRY'S FOOD DRG 088 PHOENIX AZ                01/09,-13.67,DEBIT_CARD,1211.98
DEBIT,1/9/2020,FRY'S FOOD DRG 129 PHOENIX AZ                01/08,-20.89,DEBIT_CARD,1225.65
DEBIT,1/9/2020,SPORT CLIPS - AZ141 - P PHOENIX AZ           01/08,-26,DEBIT_CARD,1246.54
DEBIT,1/8/2020,ARCO #42554 AMPM PHOENIX AZ          760397  01/08,-35.35,DEBIT_CARD,1272.54
DEBIT,1/8/2020,CVS/PHARMACY #08914 PHOENIX AZ               01/07,-5.27,DEBIT_CARD,1307.89
DEBIT,1/7/2020,CAMELBACK VW MAZDA SUB PHOENIX AZ            01/07,-297.91,DEBIT_CARD,1313.16
CREDIT,1/7/2020,Online Transfer from SAV ...9797 transaction#: 9052029400,300,ACCT_XFER,1611.07
DEBIT,1/6/2020,VZWRLSS*BILL PAY VN 800-922-0204 FL          01/06,-132.65,DEBIT_CARD,1311.07
DEBIT,1/6/2020,SANTAN BREWING CO PHOEN PHOENIX AZ           01/05,-34.87,DEBIT_CARD,1443.72
DEBIT,1/6/2020,USCONNECT ACEVN VEND  N TEMPE AZ             01/06,-1,DEBIT_CARD,1478.59
DEBIT,1/6/2020,FRY'S FOOD DRG 129 PHOENIX AZ                01/03,-9.78,DEBIT_CARD,1479.59
DEBIT,1/6/2020,GRIMALDI'S PIZZA #01101 SCOTTSDALE AZ        01/03,-24.53,DEBIT_CARD,1489.37
DEBIT,1/3/2020,WEIDNER-WF-DPTEX WEB PMTS   474385          WEB ID: 9000200905,-718,ACH_DEBIT,1513.9
DEBIT,1/3/2020,Online Transfer to SAV ...9797 transaction#: 9035956144 01/03,-600,ACCT_XFER,2231.9
DEBIT,1/3/2020,FRY'S FOOD DRG 088 PHOENIX AZ                01/02,-7.98,DEBIT_CARD,2831.9
DEBIT,1/3/2020,LUCI'SHEALTHYMARKETPLAC PHOENIX AZ           01/02,-16.63,DEBIT_CARD,2839.88
CREDIT,1/3/2020,CVO HOLDING COMP DIRECT DEP                 PPD ID: 9111111101,1388.46,ACH_CREDIT,2856.51
DEBIT,1/2/2020,FRY'S FOOD DRG 129 PHOENIX AZ                01/01,-18.96,DEBIT_CARD,1468.05
DEBIT,1/2/2020,CVS/PHARMACY #08366 PHOENIX AZ               01/01,-4.22,DEBIT_CARD,1487.01
DEBIT,1/2/2020,Classic Car Wash PHOENIX AZ                  01/01,-5,DEBIT_CARD,1491.23
DEBIT,1/2/2020,FRY'S FOOD DRG 129 PHOENIX AZ                01/01,-18.45,DEBIT_CARD,1496.23
DEBIT,1/2/2020,CVS/PHARMACY #08366 PHOENIX AZ               12/31,-12.57,DEBIT_CARD,1514.68
DEBIT,1/2/2020,USCONNECT ACEVN VEND  N TEMPE AZ             01/01,-1,DEBIT_CARD,1527.25
DEBIT,1/2/2020,CIBO LLC PHOENIX AZ                          12/31,-14.4,DEBIT_CARD,1528.25
DEBIT,1/2/2020,CIBO LLC PHOENIX AZ                          12/31,-10.6,DEBIT_CARD,1542.65
DEBIT,1/2/2020,NINTENDO    *AMERICAU 800-255-3700 WA        01/01,-21.57,DEBIT_CARD,1553.25
DEBIT,1/2/2020,OLLIE VAUGHN`S PHOENIX AZ                    12/30,-32.15,DEBIT_CARD,1574.82
DEBIT,12/31/2019,GOOGLE *YouTube Music 855-836-3987 CA        12/30,-10.85,DEBIT_CARD,1606.97
DEBIT,12/31/2019,GAMESTOP #1844 PHOENIX AZ                    12/30,-390.94,DEBIT_CARD,1617.82
DEBIT,12/30/2019,DISCOVER         E-PAYMENT  2463            WEB ID: 2510020270,-35.65,ACH_DEBIT,2008.76
DEBIT,12/30/2019,VENMO            PAYMENT    2917210113      WEB ID: 3264681992,-100,ACH_DEBIT,2044.41
DEBIT,12/30/2019,REI #56 PARADISE VAL PHOENIX AZ              12/29,-32.53,DEBIT_CARD,2144.41
DEBIT,12/30/2019,TARGET        00032615 PHOENIX AZ            12/29,-24.15,DEBIT_CARD,2176.94
DEBIT,12/30/2019,HARKINS SCOTTSDALE 101 PHOENIX AZ            12/28,-12.25,DEBIT_CARD,2201.09
DEBIT,12/30/2019,LUCI'SHEALTHYMARKETPLAC PHOENIX AZ           12/29,-30.21,DEBIT_CARD,2213.34
DEBIT,12/30/2019,TARGET        00032615 PHOENIX AZ            12/28,-8.23,DEBIT_CARD,2243.55
DEBIT,12/30/2019,76 - EXPRESS GAS 76 PHOENIX AZ               12/27,-46.12,DEBIT_CARD,2251.78
DEBIT,12/30/2019,CHIPOTLE 1684 PHOENIX AZ                     12/27,-7.76,DEBIT_CARD,2297.9
CREDIT,12/30/2019,Online Transfer from SAV ...9797 transaction#: 9021413878,400,ACCT_XFER,2305.66
CREDIT,12/30/2019,Online Transfer 9004784665 from Fifth Third Checking ######0462 transaction #: 9004784665 12/30,400,ACCT_XFER,1905.66
DEBIT,12/27/2019,CVS/PHARMACY #08366 PHOENIX AZ               12/26,-1.46,DEBIT_CARD,1505.66
DEBIT,12/26/2019,FRY'S FOOD DRG 129 PHOENIX AZ                12/24,-12.79,DEBIT_CARD,1507.12
DEBIT,12/26/2019,SP * LOOSELEAFTEAMARKE PHOENIX AZ            12/24,-12.14,DEBIT_CARD,1519.91
DEBIT,12/24/2019,TARGET        00032615 PHOENIX AZ            12/23,-19.96,DEBIT_CARD,1532.05
DEBIT,12/23/2019,CVS/PHARMACY #08366 PHOENIX AZ               12/22,-12.43,DEBIT_CARD,1552.01
DEBIT,12/23/2019,AGH MESA HOPD - TEMPE TEMPE AZ               12/22,-200,DEBIT_CARD,1564.44
DEBIT,12/23/2019,TARGET        00032615 PHOENIX AZ            12/22,-10.85,DEBIT_CARD,1764.44
DEBIT,12/23/2019,GRIMALDI'S PIZZA #01101 SCOTTSDALE AZ        12/21,-23.99,DEBIT_CARD,1775.29
DEBIT,12/23/2019,USCONNECT ACEVN VEND  N TEMPE AZ             12/22,-1,DEBIT_CARD,1799.28
DEBIT,12/23/2019,FRY'S FOOD DRG 088 PHOENIX AZ                12/20,-8.14,DEBIT_CARD,1800.28
DEBIT,12/23/2019,RA SUSHI SCOTTSDALE SCOTTSDALE AZ            12/20,-37.88,DEBIT_CARD,1808.42
DEBIT,12/20/2019,Online Transfer to SAV ...9797 transaction#: 8988425027 12/20,-500,ACCT_XFER,1846.3
DEBIT,12/20/2019,FRY'S FOOD DRG 129 PHOENIX AZ                12/19,-6.21,DEBIT_CARD,2346.3
CREDIT,12/20/2019,CVO HOLDING COMP DIRECT DEP                 PPD ID: 9111111101,1388.34,ACH_CREDIT,2352.51
DEBIT,12/19/2019,Online Payment 8984558336 To ALA 5817 12/19,-432.61,LOAN_PMT,964.17
CREDIT,12/19/2019,Online Transfer from SAV ...9797 transaction#: 8984561181,100,ACCT_XFER,1396.78
CREDIT,12/18/2019,Online Transfer 8967698214 from Fifth Third Checking ######0462 transaction #: 8967698214 12/18,600,ACCT_XFER,1296.78
DEBIT,12/16/2019,VZWRLSS*APOCC VISN 800-922-0204 FL           12/15,-132.65,DEBIT_CARD,696.78
DEBIT,12/16/2019,BEST BUY #253 PHOENIX AZ                     12/16,-108.59,DEBIT_CARD,829.43
DEBIT,12/16/2019,BEST BUY #253 PHOENIX AZ                     12/15,-55.35,DEBIT_CARD,938.02
DEBIT,12/16/2019,CULINARY DROPOUT PHOENIX AZ                  12/15,-17.39,DEBIT_CARD,993.37
DEBIT,12/16/2019,TRADER JOE'S #090  QPS PHOENIX AZ            12/15,-31.71,DEBIT_CARD,1010.76
DEBIT,12/16/2019,SANTAN BREWING CO PHOEN PHOENIX AZ           12/14,-36.84,DEBIT_CARD,1042.47
DEBIT,12/16/2019,Online Realtime Transfer to Fifth Third Checking  0462 transaction#: 8967695410 reference#: 8967695410RX 12/16,-300,ACCT_XFER,1079.31
DEBIT,12/16/2019,TARGET        00032615 PHOENIX AZ            12/13,-17.03,DEBIT_CARD,1379.31
DEBIT,12/16/2019,USCONNECT ACEVN VEND  N TEMPE AZ             12/14,-1,DEBIT_CARD,1396.34
DEBIT,12/16/2019,USCONNECT ACEVN VEND  N TEMPE AZ             12/14,-1,DEBIT_CARD,1397.34
DEBIT,12/16/2019,CVS/PHARMACY #08366 PHOENIX AZ               12/13,-23.11,DEBIT_CARD,1398.34
DEBIT,12/16/2019,KT VAL GAS STATION PHOENIX AZ                12/12,-47.56,DEBIT_CARD,1421.45
CREDIT,12/16/2019,Online Transfer from SAV ...9797 transaction#: 8971917120,100,ACCT_XFER,1469.01
CREDIT,12/16/2019,Online Transfer from SAV ...9797 transaction#: 8974470872,200,ACCT_XFER,1369.01
DEBIT,12/13/2019,UDEMY ONLINE COURSES HTTPSWWW.UDEM CA        12/12,-34.77,DEBIT_CARD,1169.01
DEBIT,12/13/2019,TARGET        00032615 PHOENIX AZ            12/12,-3.58,DEBIT_CARD,1203.78
DEBIT,12/12/2019,TARGET        00032615 PHOENIX AZ            12/11,-9.27,DEBIT_CARD,1207.36
DEBIT,12/12/2019,TFK OLO #1001 olo.com AZ                     12/12,-38.58,DEBIT_CARD,1216.63
DEBIT,12/11/2019,USCONNECT ACEVN VEND  N TEMPE AZ             12/11,-1,DEBIT_CARD,1255.21
DEBIT,12/11/2019,FRY'S FOOD DRG 088 PHOENIX AZ                12/10,-7.95,DEBIT_CARD,1256.21
DEBIT,12/10/2019,FRY'S FOOD DRG 088 PHOENIX AZ                12/09,-9.87,DEBIT_CARD,1264.16
DEBIT,12/9/2019,SPORT CLIPS - AZ141 - P PHOENIX AZ           12/08,-24,DEBIT_CARD,1274.03
DEBIT,12/9/2019,SQ *URBAN GROUNDS COFFE Phoenix AZ           12/07,-3.44,DEBIT_CARD,1298.03
DEBIT,12/9/2019,CULINARY DROPOUT PHOENIX AZ                  12/06,-74.99,DEBIT_CARD,1301.47
DEBIT,12/9/2019,FUNIMATION PRODUCTIO HTTPSWWW.FUNI TX        12/06,-2.99,DEBIT_CARD,1376.46
DEBIT,12/9/2019,ELLYS PANCAKE BRUNCH CA PHOENIX AZ           12/06,-15.49,DEBIT_CARD,1379.45
DEBIT,12/6/2019,Online Transfer to SAV ...9797 transaction#: 8936799270 12/06,-1000,ACCT_XFER,1394.94
CREDIT,12/6/2019,CVO HOLDING COMP DIRECT DEP                 PPD ID: 9111111101,1388.33,ACH_CREDIT,2394.94
DEBIT,12/5/2019,TARGET        00032615 PHOENIX AZ            12/04,-8.57,DEBIT_CARD,1006.61
DEBIT,12/3/2019,WEIDNER-WF-DPTEX WEB PMTS   NNK645          WEB ID: 9000200905,-721.49,ACH_DEBIT,1015.18
DEBIT,12/3/2019,TRADER JOE'S #090  QPS PHOENIX AZ            12/02,-30.33,DEBIT_CARD,1736.67
DEBIT,12/3/2019,FRY'S FOOD DRG 088 PHOENIX AZ                12/02,-7.98,DEBIT_CARD,1767
DEBIT,12/2/2019,GOOGLE *YouTube Music 855-836-3987 CA        11/30,-10.85,DEBIT_CARD,1774.98
DEBIT,12/2/2019,7619 Dominos Pizza PHOENIX AZ                12/01,-18.43,DEBIT_CARD,1785.83
DEBIT,12/2/2019,PHX DRUGS & MORE PHOENIX AZ                  12/01,-4.79,DEBIT_CARD,1804.26
DEBIT,12/2/2019,THE FINAL FRAME CROWN POINT IN               11/30,-27,DEBIT_CARD,1809.05
DEBIT,12/2/2019,AMERICAN AIR00106110915 FORT WORTH TX        11/30,-71.25,DEBIT_CARD,1836.05
DEBIT,12/2/2019,AMERICAN AIR00106110915 FORT WORTH TX        11/30,-74.1,DEBIT_CARD,1907.3
DEBIT,12/2/2019,RED ROBIN NO 649 MERRILLVILLE IN             11/30,-52.32,DEBIT_CARD,1981.4
DEBIT,12/2/2019,6375 AMC HOBART 12 MERRILLVILLE IN           11/29,-11.75,DEBIT_CARD,2033.72
CREDIT,12/2/2019,ATM CHECK DEPOSIT 12/02 5041 N 16TH ST PHOENIX AZ,500,ATM_DEPOSIT,2045.47
DEBIT,11/29/2019,CVS/PHARMACY #08366 PHOENIX AZ               11/27,-11.82,DEBIT_CARD,1545.47
DEBIT,11/29/2019,LUCI'SHEALTHYMARKETPLAC PHOENIX AZ           11/27,-7.67,DEBIT_CARD,1557.29
DEBIT,11/27/2019,CHEGG  ORDER 844-224-5952 CA                 11/26,-16.24,DEBIT_CARD,1564.96
DEBIT,11/27/2019,CVS/PHARMACY #08914 PHOENIX AZ               11/26,-3.78,DEBIT_CARD,1581.2
DEBIT,11/27/2019,TRUE FOOD KITCHEN #1001 PHOENIX AZ           11/25,-33.24,DEBIT_CARD,1584.98
DEBIT,11/27/2019,LUCI'SHEALTHYMARKETPLAC PHOENIX AZ           11/26,-7.03,DEBIT_CARD,1618.22
DEBIT,11/26/2019,TARGET        00032615 PHOENIX AZ            11/25,-4.39,DEBIT_CARD,1625.25
DEBIT,11/26/2019,LUCI'SHEALTHYMARKETPLAC PHOENIX AZ           11/25,-8.87,DEBIT_CARD,1629.64
DEBIT,11/25/2019,SHELL SERVICE S PHOENIX AZ                   11/25,-48.84,DEBIT_CARD,1638.51
DEBIT,11/25/2019,ELLYS PANCAKE BRUNCH CA PHOENIX AZ           11/23,-12.05,DEBIT_CARD,1687.35
DEBIT,11/25/2019,SANTAN BREWING CO PHOEN PHOENIX AZ           11/22,-18.48,DEBIT_CARD,1699.4
DEBIT,11/25/2019,TARGET        00032615 PHOENIX AZ            11/22,-26.03,DEBIT_CARD,1717.88
DEBIT,11/25/2019,LUCI'SHEALTHYMARKETPLAC PHOENIX AZ           11/23,-2.44,DEBIT_CARD,1743.91
DEBIT,11/25/2019,LUCI'SHEALTHYMARKETPLAC PHOENIX AZ           11/23,-7.67,DEBIT_CARD,1746.35
DEBIT,11/25/2019,LUCI'SHEALTHYMARKETPLAC PHOENIX AZ           11/22,-3.44,DEBIT_CARD,1754.02
DEBIT,11/22/2019,Online Transfer to SAV ...9797 transaction#: 8885897966 11/22,-1100,ACCT_XFER,1757.46
DEBIT,11/22/2019,SPOONZ CAFE PHOENIX AZ                       11/21,-2.77,DEBIT_CARD,2857.46
DEBIT,11/22/2019,LUCI'SHEALTHYMARKETPLAC PHOENIX AZ           11/21,-9.38,DEBIT_CARD,2860.23
CREDIT,11/22/2019,CVO HOLDING COMP DIRECT DEP                 PPD ID: 9111111101,1388.33,ACH_CREDIT,2869.61
DEBIT,11/20/2019,"SQ *COOKIE BROKERS, PHOENIX AZ               11/19",-7.52,DEBIT_CARD,1481.28
DEBIT,11/20/2019,TARGET        00032615 PHOENIX AZ            11/19,-11.98,DEBIT_CARD,1488.8
DEBIT,11/19/2019,APS electric pmt PAYMENT    3518057919      WEB ID: 1860011170,-122.39,ACH_DEBIT,1500.78
DEBIT,11/19/2019,FRY'S FOOD DRG 088 PHOENIX AZ                11/18,-7.88,DEBIT_CARD,1623.17
DEBIT,11/19/2019,GCU STUDENT UNION PHOENIX AZ                 11/18,-6.49,DEBIT_CARD,1631.05
DEBIT,11/19/2019,LUCI'SHEALTHYMARKETPLAC PHOENIX AZ           11/18,-13.23,DEBIT_CARD,1637.54
DEBIT,11/18/2019,DISCOVER         E-PAYMENT  2463            WEB ID: 2510020270,-9.07,ACH_DEBIT,1650.77
DEBIT,11/18/2019,VENMO            PAYMENT    2750197744      WEB ID: 3264681992,-22,ACH_DEBIT,1659.84
DEBIT,11/18/2019,BEST BUY         PAYMENT    133121062481348 WEB ID: CITICTP,-174.76,ACH_DEBIT,1681.84
DEBIT,11/18/2019,GRAPES COOPER TEES JEROME AZ                 11/17,-3.6,DEBIT_CARD,1856.6
DEBIT,11/18/2019,CHEVRON 0202512 CAMP VERDE AZ                11/17,-2.74,DEBIT_CARD,1860.2
DEBIT,11/18/2019,Online Transfer to SAV ...9797 transaction#: 8868471742 11/18,-3000,ACCT_XFER,1862.94
DEBIT,11/18/2019,AT HOME STORE 206 TEMPE AZ                   11/15,-410.77,DEBIT_CARD,4862.94
DEBIT,11/18/2019,190PEPSIVEN9147678600 PHOENIX AZ             11/15,-1.5,DEBIT_CARD,5273.71
DEBIT,11/18/2019,CVS/PHARMACY #09297 PHOENIX AZ               11/15,-20.06,DEBIT_CARD,5275.21
CREDIT,11/18/2019,VENMO            CASHOUT                    PPD ID: 5264681992,200,ACH_CREDIT,5295.27
DEBIT,11/15/2019,VZWRLSS*APOCC VISN 800-922-0204 FL           11/15,-132.65,DEBIT_CARD,5095.27
DEBIT,11/15/2019,AT HOME STORE 2 TEMPE AZ                     11/15,-216.19,DEBIT_CARD,5227.92
DEBIT,11/15/2019,Online Payment 8861997397 To Auto Loan 5817 11/15,-432.61,LOAN_PMT,5444.11
DEBIT,11/15/2019,POTBELLY #285 PHOENIX AZ                     11/14,-9.21,DEBIT_CARD,5876.72
CREDIT,11/15/2019,Online Transfer 8853629311 from Fifth Third Checking ######0462 transaction #: 8853629311 11/15,1100,ACCT_XFER,5885.93
DEBIT,11/14/2019,SHELL OIL 12685754009 PHOENIX AZ             11/13,-6,DEBIT_CARD,4785.93
DEBIT,11/14/2019,LUCI'SHEALTHYMARKETPLAC PHOENIX AZ           11/13,-3.44,DEBIT_CARD,4791.93
DEBIT,11/13/2019,SANTAN BREWING CO PHOEN PHOENIX AZ           11/12,-35.21,DEBIT_CARD,4795.37
DEBIT,11/13/2019,SPECTRUM DERMATOLOGY 000-0000000 AZ          11/11,-81.43,DEBIT_CARD,4830.58
DEBIT,11/13/2019,LUCI'SHEALTHYMARKETPLAC PHOENIX AZ           11/12,-3.37,DEBIT_CARD,4912.01
CREDIT,11/13/2019,VENMO            CASHOUT                    PPD ID: 5264681992,131,ACH_CREDIT,4915.38
DEBIT,11/12/2019,QUIKTRIP CORP PHOENIX AZ             017503  11/11,-49.62,DEBIT_CARD,4784.38
DEBIT,11/12/2019,FRY'S FOOD DRG 129 PHOENIX AZ                11/11,-8.49,DEBIT_CARD,4834
DEBIT,11/12/2019,FAIRMONT SCOTTSDALE PRI SCOTTSDALE AZ        11/10,-8,DEBIT_CARD,4842.49
DEBIT,11/12/2019,IKEA TEMPE TEMPE AZ                  555788  11/10,-139.45,DEBIT_CARD,4850.49
DEBIT,11/12/2019,TARGET        00032615 PHOENIX AZ            11/09,-12.67,DEBIT_CARD,4989.94
DEBIT,11/12/2019,TARGET        00032615 PHOENIX AZ            11/09,-14.36,DEBIT_CARD,5002.61
DEBIT,11/12/2019,ELEVATE COFFEE COMPANY PHOENIX AZ            11/09,-4.15,DEBIT_CARD,5016.97
DEBIT,11/12/2019,GG AND D MOTOR VEHICLE PHOENIX AZ            11/08,-60.5,DEBIT_CARD,5021.12
DEBIT,11/12/2019,CIRCLE K 01618 PHOENIX AZ                    11/08,-30.48,DEBIT_CARD,5081.62
DEBIT,11/12/2019,LUCI'SHEALTHYMARKETPLAC PHOENIX AZ           11/09,-4.37,DEBIT_CARD,5112.1
DEBIT,11/12/2019,LUCI'SHEALTHYMARKETPLAC PHOENIX AZ           11/08,-3.37,DEBIT_CARD,5116.47
CREDIT,11/8/2019,CVO HOLDING COMP DIRECT DEP                 PPD ID: 9111111101,1388.34,ACH_CREDIT,5119.84
DEBIT,11/7/2019,CULINARY DROPOUT PHOENIX AZ                  11/06,-58.96,DEBIT_CARD,3731.5
DEBIT,11/7/2019,FRY'S FOOD DRG 129 PHOENIX AZ                11/06,-12.94,DEBIT_CARD,3790.46
DEBIT,11/7/2019,TST* ZOOKZ - E CAMELBAC PHOENIX AZ           11/07,-12.16,DEBIT_CARD,3803.4
DEBIT,11/7/2019,SCRAMBLE A BREAKFAST JO PHOENIX AZ           11/05,-18.94,DEBIT_CARD,3815.56
DEBIT,11/7/2019,LUCI'SHEALTHYMARKETPLAC PHOENIX AZ           11/06,-4.37,DEBIT_CARD,3834.5
DEBIT,11/6/2019,FRY'S FOOD DRG 129 PHOENIX AZ                11/05,-19.56,DEBIT_CARD,3838.87
DEBIT,11/5/2019,CHIPOTLE 1684 PHOENIX AZ                     11/04,-9.67,DEBIT_CARD,3858.43
DEBIT,11/4/2019,The Trend at 51  Rent       102241050       WEB ID: 1861072180,-722,ACH_DEBIT,3868.1
DEBIT,11/4/2019,FRY'S FOOD DRG 129 PHOENIX AZ                11/03,-10.66,DEBIT_CARD,4590.1
DEBIT,11/4/2019,CVS/PHARMACY #08366 PHOENIX AZ               11/03,-4.98,DEBIT_CARD,4600.76
DEBIT,11/4/2019,SPORT CLIPS - AZ141 - P PHOENIX AZ           11/03,-26,DEBIT_CARD,4605.74
DEBIT,11/4/2019,FAME PHOENIX AZ                              11/03,-16.03,DEBIT_CARD,4631.74
DEBIT,11/4/2019,SCRAMBLE A BREAKFAST JO PHOENIX AZ           11/02,-38.07,DEBIT_CARD,4647.77
DEBIT,11/4/2019,SHELL SERVICE S SCOTTSDALE AZ                11/01,-29.05,DEBIT_CARD,4685.84
DEBIT,11/4/2019,TST* ZOOKZ - E CAMELBAC PHOENIX AZ           11/02,-12.16,DEBIT_CARD,4714.89
DEBIT,11/4/2019,LUCI'SHEALTHYMARKETPLAC PHOENIX AZ           11/02,-3.37,DEBIT_CARD,4727.05
DEBIT,11/4/2019,LUCI'SHEALTHYMARKETPLAC PHOENIX AZ           11/01,-4.37,DEBIT_CARD,4730.42
CREDIT,11/4/2019,VENMO            CASHOUT                    PPD ID: 5264681992,150,ACH_CREDIT,4734.79
DEBIT,11/1/2019,TARGET        00032615 PHOENIX AZ            10/31,-8.89,DEBIT_CARD,4584.79
DEBIT,10/31/2019,GOOGLE *YouTube Music 855-836-3987 CA        10/30,-10.85,DEBIT_CARD,4593.68
DEBIT,10/31/2019,TST* ZOOKZ - E CAMELBAC PHOENIX AZ           10/31,-12.16,DEBIT_CARD,4604.53
DEBIT,10/31/2019,GCU STUDENT UNION PHOENIX AZ                 10/30,-2.99,DEBIT_CARD,4616.69
DEBIT,10/30/2019,CHIPOTLE 1684 PHOENIX AZ                     10/29,-7.55,DEBIT_CARD,4619.68
CREDIT,10/30/2019,Online Transfer 8792660382 from Fifth Third Checking ######0462 transaction #: 8792660382 10/30,200,ACCT_XFER,4627.23
DEBIT,10/29/2019,WHOLEFDS CMA #10476 PHOENIX AZ               10/28,-42.05,DEBIT_CARD,4427.23
DEBIT,10/29/2019,GCU STUDENT UNION PHOENIX AZ                 10/28,-2.99,DEBIT_CARD,4469.28
DEBIT,10/29/2019,PIZZA POWER LLC PHOENIX AZ                   10/28,-17.62,DEBIT_CARD,4472.27
DEBIT,10/28/2019,CHEGG  ORDER 844-224-5952 CA                 10/26,-16.24,DEBIT_CARD,4489.89
DEBIT,10/28/2019,CIRCLE K 01541 PHOENIX AZ                    10/27,-30,DEBIT_CARD,4506.13
DEBIT,10/28/2019,GCU STUDENT UNION PHOENIX AZ                 10/26,-9.75,DEBIT_CARD,4536.13
DEBIT,10/28/2019,SQ *BOSA DONUTS Phoenix AZ                   10/26,-6.51,DEBIT_CARD,4545.88
DEBIT,10/28/2019,SANTAN BREWING CO PHOEN PHOENIX AZ           10/25,-28.44,DEBIT_CARD,4552.39
DEBIT,10/28/2019,TOTAL WINE AND MORE 100 PHOENIX AZ           10/25,-16.28,DEBIT_CARD,4580.83
DEBIT,10/28/2019,USCONNECT ACEVN VEND  N TEMPE AZ             10/26,-1,DEBIT_CARD,4597.11
DEBIT,10/28/2019,TST* ZOOKZ - E CAMELBAC PHOENIX AZ           10/26,-18.95,DEBIT_CARD,4598.11
DEBIT,10/28/2019,FRY'S FOOD DRG 129 PHOENIX AZ                10/24,-8.12,DEBIT_CARD,4617.06
DEBIT,10/28/2019,SPECTRUM DERMATOLOGY SCOTTSDALE AZ           10/24,-30,DEBIT_CARD,4625.18
DEBIT,10/25/2019,SUBWAY        00104703 PHOENIX AZ            10/22,-9.75,DEBIT_CARD,4655.18
CREDIT,10/25/2019,VENMO            CASHOUT                    PPD ID: 5264681992,106,ACH_CREDIT,4664.93
CREDIT,10/25/2019,CVO HOLDING COMP DIRECT DEP                 PPD ID: 9111111101,1388.34,ACH_CREDIT,4558.93
DEBIT,10/24/2019,FRY'S FOOD DRG 129 PHOENIX AZ                10/23,-5.79,DEBIT_CARD,3170.59
DEBIT,10/24/2019,FRY'S FOOD DRG 129 PHOENIX AZ                10/23,-41.96,DEBIT_CARD,3176.38
DEBIT,10/22/2019,CIBO LLC PHOENIX AZ                          10/21,-17.12,DEBIT_CARD,3218.34
DEBIT,10/21/2019,TARGET        00032615 PHOENIX AZ            10/18,-13.46,DEBIT_CARD,3235.46
DEBIT,10/21/2019,WILDFLOWE 011 ARCADIA PHOENIX AZ             10/18,-24.29,DEBIT_CARD,3248.92
DEBIT,10/21/2019,SHELL OIL 12685754009 PHOENIX AZ             10/18,-30.01,DEBIT_CARD,3273.21
CREDIT,10/21/2019,Online Transfer 8761394413 from Fifth Third Checking ######0462 transaction #: 8761394413 10/21,300,ACCT_XFER,3303.22
DEBIT,10/18/2019,SQ *PRESS BILTMORE Phoenix AZ                10/17,-24.98,DEBIT_CARD,3003.22
DEBIT,10/18/2019,SQ *PRESS BILTMORE Phoenix AZ                10/17,-5.88,DEBIT_CARD,3028.2
DEBIT,10/17/2019,APS electric pmt PAYMENT    3518057919      WEB ID: 1860011170,-129.67,ACH_DEBIT,3034.08
DEBIT,10/17/2019,USCONNECT ACEVN VEND  N TEMPE AZ             10/17,-1,DEBIT_CARD,3163.75
DEBIT,10/17/2019,FRY'S FOOD DRG 129 PHOENIX AZ                10/16,-24.1,DEBIT_CARD,3164.75
DEBIT,10/17/2019,CHIPOTLE 1684 PHOENIX AZ                     10/16,-7.55,DEBIT_CARD,3188.85
DEBIT,10/16/2019,SQ *PRESS BILTMORE Phoenix AZ                10/15,-2.72,DEBIT_CARD,3196.4
DEBIT,10/16/2019,GCU STUDENT UNION PHOENIX AZ                 10/15,-9.67,DEBIT_CARD,3199.12
DEBIT,10/15/2019,TRADER JOE'S #090  QPS PHOENIX AZ            10/14,-5.28,DEBIT_CARD,3208.79
DEBIT,10/15/2019,WILLIAMS-SONOMA 0020 PHOENIX AZ              10/13,-177.96,DEBIT_CARD,3214.07
DEBIT,10/15/2019,FRY'S FOOD DRG 129 PHOENIX AZ                10/13,-27.59,DEBIT_CARD,3392.03
DEBIT,10/15/2019,LUCI'SHEALTHYMARKETPLAC PHOENIX AZ           10/14,-16.54,DEBIT_CARD,3419.62
DEBIT,10/15/2019,SAFEWAY #1253 SCOTTSDALE AZ                  10/12,-3.54,DEBIT_CARD,3436.16
DEBIT,10/15/2019,BICYCLE RANCH SCOTTSDALE AZ                  10/12,-52.93,DEBIT_CARD,3439.7
DEBIT,10/15/2019,CIRCLE K # 41604 1015 CHANDLER AZ            10/12,-29.55,DEBIT_CARD,3492.63
DEBIT,10/15/2019,SQ *PRESS BILTMORE Phoenix AZ                10/12,-2.72,DEBIT_CARD,3522.18
DEBIT,10/15/2019,FRY'S FOOD DRG 129 PHOENIX AZ                10/11,-30.99,DEBIT_CARD,3524.9
DEBIT,10/15/2019,HALF PRICE BOOKS #106 PHOENIX AZ             10/11,-5.42,DEBIT_CARD,3555.89
CREDIT,10/15/2019,VENMO            CASHOUT                    PPD ID: 5264681992,80,ACH_CREDIT,3561.31
DEBIT,10/11/2019,VENMO            PAYMENT    2599674116      WEB ID: 3264681992,-3,ACH_DEBIT,3481.31
DEBIT,10/11/2019,CULINARY DROPOUT PHOENIX AZ                  10/10,-31.34,DEBIT_CARD,3484.31
CREDIT,10/11/2019,CVO HOLDING COMP DIRECT DEP                 PPD ID: 9111111101,1388.34,ACH_CREDIT,3515.65
DEBIT,10/10/2019,FRY'S FOOD DRG 129 PHOENIX AZ                10/09,-36.37,DEBIT_CARD,2127.31
DEBIT,10/10/2019,JIMMY JOHNS - 1635 PHOENIX AZ                10/09,-9.97,DEBIT_CARD,2163.68
DEBIT,10/10/2019,CHICK-FIL-A #03191 PHOENIX AZ                10/08,-8.89,DEBIT_CARD,2173.65
DEBIT,10/8/2019,TRADER JOE'S #090  QPS PHOENIX AZ            10/07,-8.97,DEBIT_CARD,2182.54
DEBIT,10/8/2019,SHELL OIL 12685754009 PHOENIX AZ             10/07,-25.01,DEBIT_CARD,2191.51
DEBIT,10/7/2019,VZWRLSS*BILL PAY VN 800-922-0204 FL          10/05,-132.65,DEBIT_CARD,2216.52
DEBIT,10/7/2019,TRADER JOE'S #090  QPS PHOENIX AZ            10/05,-20.73,DEBIT_CARD,2349.17
DEBIT,10/7/2019,STAPLES       00102632 PHOENIX AZ            10/05,-2.7,DEBIT_CARD,2369.9
DEBIT,10/7/2019,AMERICAN EAGLE SCOTTSDALE AZ                 10/05,-145.69,DEBIT_CARD,2372.6
DEBIT,10/7/2019,FAME PHOENIX AZ                              10/05,-29.79,DEBIT_CARD,2518.29
DEBIT,10/7/2019,SUBWAY        00104703 PHOENIX AZ            10/04,-11.27,DEBIT_CARD,2548.08
DEBIT,10/7/2019,AMERICAN EAGLE SCOTTSDALE AZ                 10/06,40.48,DEBIT_CARD,2559.35
DEBIT,10/4/2019,Online Payment 8713865478 To Auto Loan 5817 10/04,-432.61,LOAN_PMT,2518.87
DEBIT,10/4/2019,FRY'S FOOD DRG 129 PHOENIX AZ                10/03,-7.52,DEBIT_CARD,2951.48
DEBIT,10/3/2019,The Trend at 51  Rent       101262896       WEB ID: 1861072180,-1421.65,ACH_DEBIT,2959
DEBIT,10/3/2019,SUBWAY        00104703 PHOENIX AZ            10/02,-7.8,DEBIT_CARD,4380.65
DEBIT,10/2/2019,Prime Video*F22HP7OZ3 888-802-3080 WA        10/02,-7.59,DEBIT_CARD,4388.45
DEBIT,10/2/2019,FRY'S FOOD DRG 129 PHOENIX AZ                10/01,-33.68,DEBIT_CARD,4396.04
DEBIT,10/2/2019,SQ *PRESS BILTMORE Phoenix AZ                10/01,-21.72,DEBIT_CARD,4429.72
DEBIT,10/2/2019,LUCI'SHEALTHYMARKETPLAC PHOENIX AZ           10/01,-3.37,DEBIT_CARD,4451.44
CREDIT,10/2/2019,VENMO            CASHOUT                    PPD ID: 5264681992,691,ACH_CREDIT,4454.81
DEBIT,10/1/2019,FRY'S FOOD DRG 129 PHOENIX AZ                09/30,-13.76,DEBIT_CARD,3763.81
DEBIT,10/1/2019,SPORT CLIPS - AZ141 - P PHOENIX AZ           09/29,-24,DEBIT_CARD,3777.57
DEBIT,9/30/2019,HOPDODDY PHOENIX C-B PHOENIX AZ              09/29,-13.29,DEBIT_CARD,3801.57
DEBIT,9/30/2019,CIRCLE K 01619 PHOENIX AZ                    09/29,-40,DEBIT_CARD,3814.86
DEBIT,9/30/2019,SQ *PRESS BILTMORE Phoenix AZ                09/29,-3.98,DEBIT_CARD,3854.86
DEBIT,9/30/2019,TARGET        00032615 PHOENIX AZ            09/29,-22.8,DEBIT_CARD,3858.84
DEBIT,9/30/2019,TARGET        00032615 PHOENIX AZ            09/28,-3.79,DEBIT_CARD,3881.64
DEBIT,9/30/2019,GCU STUDENT UNION PHOENIX AZ                 09/28,-2.49,DEBIT_CARD,3885.43
DEBIT,9/30/2019,LUCI'SHEALTHYMARKETPLAC PHOENIX AZ           09/29,-8.87,DEBIT_CARD,3887.92
DEBIT,9/30/2019,FRY'S FOOD DRG 129 PHOENIX AZ                09/27,-3.78,DEBIT_CARD,3896.79
DEBIT,9/30/2019,GCU STUDENT UNION PHOENIX AZ                 09/27,-6.73,DEBIT_CARD,3900.57
DEBIT,9/30/2019,LUCI'SHEALTHYMARKETPLAC PHOENIX AZ           09/27,-6.23,DEBIT_CARD,3907.3
DEBIT,9/27/2019,CHEGG  ORDER 844-224-5952 CA                 09/27,-16.24,DEBIT_CARD,3913.53
DEBIT,9/27/2019,FRY'S FOOD DRG 129 PHOENIX AZ                09/26,-18.88,DEBIT_CARD,3929.77
DEBIT,9/27/2019,STARBUCKS STORE 06954 PHOENIX AZ             09/26,-2.33,DEBIT_CARD,3948.65
CREDIT,9/27/2019,CVO HOLDING COMP DIRECT DEP                 PPD ID: 9111111101,1388.33,ACH_CREDIT,3950.98
DEBIT,9/26/2019,SUBWAY        00104703 PHOENIX AZ            09/25,-9.75,DEBIT_CARD,2562.65
DEBIT,9/26/2019,CHICK-FIL-A #03191 PHOENIX AZ                09/24,-8.45,DEBIT_CARD,2572.4
DEBIT,9/26/2019,LUCI'SHEALTHYMARKETPLAC PHOENIX AZ           09/25,-4.26,DEBIT_CARD,2580.85
DEBIT,9/25/2019,APS electric pmt PAYMENT    3518057919      WEB ID: 1860011170,-229.86,ACH_DEBIT,2585.11
DEBIT,9/25/2019,CORNISH PASTY PHOENIX AZ                     09/23,-20.1,DEBIT_CARD,2814.97
DEBIT,9/24/2019,SUBWAY        00104703 PHOENIX AZ            09/23,-7.8,DEBIT_CARD,2835.07
DEBIT,9/24/2019,GCU STUDENT UNION PHOENIX AZ                 09/23,-10.05,DEBIT_CARD,2842.87
DEBIT,9/24/2019,FRY'S FOOD DRG 129 PHOENIX AZ                09/22,-6.97,DEBIT_CARD,2852.92
DEBIT,9/24/2019,ABM BILTMORE FINANCIAL PHOENIX AZ            09/22,-1.25,DEBIT_CARD,2859.89
DEBIT,9/23/2019,SQ *PRESS BILTMORE Phoenix AZ                09/23,-6.7,DEBIT_CARD,2861.14
DEBIT,9/23/2019,CVS/PHARMACY #08366 PHOENIX AZ               09/22,-14.17,DEBIT_CARD,2867.84
DEBIT,9/23/2019,TRUE FOOD KITCHEN #1001 PHOENIX AZ           09/21,-19.29,DEBIT_CARD,2882.01
DEBIT,9/23/2019,SQ *PRESS BILTMORE Phoenix AZ                09/21,-3.72,DEBIT_CARD,2901.3
DEBIT,9/23/2019,GRIMALDI'S PIZZA #01101 SCOTTSDALE AZ        09/20,-27.69,DEBIT_CARD,2905.02
DEBIT,9/23/2019,SUBWAY        00104703 PHOENIX AZ            09/20,-9.75,DEBIT_CARD,2932.71
CREDIT,9/23/2019,ATM CASH DEPOSIT 09/21 5041 N 16TH ST PHOENIX AZ,50,ATM,2942.46
CREDIT,9/23/2019,ATM CHECK DEPOSIT 09/21 5041 N 16TH ST PHOENIX AZ,107.95,ATM_DEPOSIT,2892.46
DEBIT,9/20/2019,FRY'S FOOD DRG 129 PHOENIX AZ                09/19,-12.32,DEBIT_CARD,2784.51
DEBIT,9/20/2019,CIRCLE K # 03447 PHOENIX AZ                  09/18,-40.44,DEBIT_CARD,2796.83
DEBIT,9/19/2019,GCU STUDENT UNION PHOENIX AZ                 09/18,-7.59,DEBIT_CARD,2837.27
DEBIT,9/19/2019,TEAMTREEHOUSE.COM 800-928-2130 FL            09/18,-25,DEBIT_CARD,2844.86
DEBIT,9/19/2019,STEAMGAMES.COM 4259522 425-8899642 WA        09/19,-14.99,DEBIT_CARD,2869.86
DEBIT,9/18/2019,CVS/PHARMACY #08366 PHOENIX AZ               09/17,-13.64,DEBIT_CARD,2884.85
CREDIT,9/17/2019,Online Transfer 8641692361 from Fifth Third Checking ######0462 transaction #: 8641692361 09/17,300,ACCT_XFER,2898.49
DEBIT,9/16/2019,VZWRLSS*APOCC VISN 800-922-0204 FL           09/15,-132.65,DEBIT_CARD,2598.49
DEBIT,9/16/2019,TARGET        00032615 PHOENIX AZ            09/15,-16.21,DEBIT_CARD,2731.14
DEBIT,9/16/2019,FRY'S FOOD DRG 129 PHOENIX AZ                09/14,-20.13,DEBIT_CARD,2747.35
DEBIT,9/16/2019,GUITAR CENTER #151 TEMPE AZ                  09/14,-37.81,DEBIT_CARD,2767.48
DEBIT,9/16/2019,USCONNECT ACEVN VEND  N TEMPE AZ             09/15,-1.6,DEBIT_CARD,2805.29
DEBIT,9/16/2019,IKEA TEMPE TEMPE AZ                  256133  09/14,-625.9,DEBIT_CARD,2806.89
DEBIT,9/16/2019,ELLYS PANCAKE BRUNCH CA PHOENIX AZ           09/14,-38.31,DEBIT_CARD,3432.79
DEBIT,9/16/2019,TST* ZOOKZ - E CAMELBAC PHOENIX AZ           09/14,-24.09,DEBIT_CARD,3471.1
DEBIT,9/16/2019,GCU STUDENT UNION PHOENIX AZ                 09/13,-2.44,DEBIT_CARD,3495.19
DEBIT,9/16/2019,CORNISH PASTY PHOENIX AZ                     09/13,-16.21,DEBIT_CARD,3497.63
CREDIT,9/16/2019,VENMO            CASHOUT                    PPD ID: 5264681992,300,ACH_CREDIT,3513.84
DEBIT,9/13/2019,CHICK-FIL-A #03191 PHOENIX AZ                09/11,-8.89,DEBIT_CARD,3213.84
CREDIT,9/13/2019,CVO HOLDING COMP DIRECT DEP                 PPD ID: 9111111101,1388.33,ACH_CREDIT,3222.73
DEBIT,9/12/2019,Online Payment 8636531563 To Auto Loan 5817 09/12,-432.61,LOAN_PMT,1834.4
CREDIT,9/12/2019,Online Transfer 8630360956 from Fifth Third Checking ######0462 transaction #: 8630360956 09/12,800,ACCT_XFER,2267.01
DEBIT,9/11/2019,GCU STUDENT UNION PHOENIX AZ                 09/10,-2.44,DEBIT_CARD,1467.01
DEBIT,9/11/2019,GCU STUDENT UNION PHOENIX AZ                 09/10,-6.51,DEBIT_CARD,1469.45
DEBIT,9/11/2019,GCU STUDENT UNION PHOENIX AZ                 09/10,-2.44,DEBIT_CARD,1475.96
DEBIT,9/11/2019,FRY'S FOOD DRG 129 PHOENIX AZ                09/09,-21.58,DEBIT_CARD,1478.4
DEBIT,9/10/2019,The Trend at 51  Rent       100418311       WEB ID: 1861072180,-0.01,ACH_DEBIT,1499.98
DEBIT,9/10/2019,The Trend at 51  Rent       100418310       WEB ID: 1861072180,-1225.42,ACH_DEBIT,1499.99
DEBIT,9/9/2019,DISCOVER         E-PAYMENT  2463            WEB ID: 2510020270,-576.27,ACH_DEBIT,2725.41
DEBIT,9/9/2019,FRY'S FOOD DRG 129 PHOENIX AZ                09/08,-42.39,DEBIT_CARD,3301.68
DEBIT,9/9/2019,FRY'S FOOD DRG 054 SCOTTSDALE AZ             09/08,-11.72,DEBIT_CARD,3344.07
DEBIT,9/9/2019,ELLY S BRUNCH & CAFE PH PHOENIX AZ           09/08,-15.9,DEBIT_CARD,3355.79
DEBIT,9/9/2019,CULINARY DROPOUT PHOENIX AZ                  09/07,-23.01,DEBIT_CARD,3371.69
DEBIT,9/9/2019,CULINARY DROPOUT PHOENIX AZ                  09/07,-23.55,DEBIT_CARD,3394.7
DEBIT,9/9/2019,LUCI'SHEALTHYMARKETPLAC PHOENIX AZ           09/08,-8.87,DEBIT_CARD,3418.25
DEBIT,9/9/2019,CIRCLE K 01541 PHOENIX AZ                    09/06,-40,DEBIT_CARD,3427.12
DEBIT,9/9/2019,GCU STUDENT UNION PHOENIX AZ                 09/06,-10.62,DEBIT_CARD,3467.12
DEBIT,9/9/2019,GCU STUDENT UNION PHOENIX AZ                 09/06,-4.35,DEBIT_CARD,3477.74
DEBIT,9/9/2019,LUCI'SHEALTHYMARKETPLAC PHOENIX AZ           09/07,-9.54,DEBIT_CARD,3482.09
DEBIT,9/9/2019,LUCI'SHEALTHYMARKETPLAC PHOENIX AZ           09/06,-3.44,DEBIT_CARD,3491.63
CREDIT,9/9/2019,VENMO            CASHOUT                    PPD ID: 5264681992,100,ACH_CREDIT,3495.07
CREDIT,9/9/2019,VENMO            CASHOUT                    PPD ID: 5264681992,610,ACH_CREDIT,3395.07
DEBIT,9/6/2019,VENMO            PAYMENT    2461517347      WEB ID: 3264681992,-100,ACH_DEBIT,2785.07
DEBIT,9/6/2019,GCU STUDENT UNION PHOENIX AZ                 09/05,-8.39,DEBIT_CARD,2885.07
DEBIT,9/6/2019,GCU STUDENT UNION PHOENIX AZ                 09/05,-6.07,DEBIT_CARD,2893.46
DEBIT,9/6/2019,GCU STUDENT UNION PHOENIX AZ                 09/05,-4.78,DEBIT_CARD,2899.53
DEBIT,9/6/2019,GCU STUDENT UNION PHOENIX AZ                 09/05,-6.07,DEBIT_CARD,2904.31
DEBIT,9/5/2019,GCU STUDENT UNION PHOENIX AZ                 09/04,-7.82,DEBIT_CARD,2910.38
DEBIT,9/4/2019,The Trend at 51  Rent       100216796       WEB ID: 1861072180,-305.53,ACH_DEBIT,2918.2
DEBIT,9/4/2019,SQ *PRESS BILTMORE Phoenix AZ                09/04,-3.98,DEBIT_CARD,3223.73
DEBIT,9/4/2019,TST* SIP COFFEE & BEER PHOENIX AZ            09/04,-14.03,DEBIT_CARD,3227.71
DEBIT,9/4/2019,CVS/PHARMACY #08366 PHOENIX AZ               09/03,-5.35,DEBIT_CARD,3241.74
DEBIT,9/4/2019,GCU STUDENT UNION PHOENIX AZ                 09/03,-11.25,DEBIT_CARD,3247.09
DEBIT,9/3/2019,TST* OVER EASY - BILTMO PHOENIX AZ           09/02,-14.92,DEBIT_CARD,3258.34
DEBIT,9/3/2019,0190 AMC DESERT RIDGE 1 PHOENIX AZ           09/02,-11.71,DEBIT_CARD,3273.26
DEBIT,9/3/2019,SQ *ESSO COFFEEHOUSE AN Phoenix AZ           09/01,-3.45,DEBIT_CARD,3284.97
DEBIT,9/3/2019,ELLY S BRUNCH & CAFE PH PHOENIX AZ           08/31,-36.14,DEBIT_CARD,3288.42
CREDIT,9/3/2019,VENMO            CASHOUT                    PPD ID: 5264681992,150,ACH_CREDIT,3324.56
DEBIT,8/30/2019,FRY'S FOOD DRG 129 PHOENIX AZ                08/29,-16.16,DEBIT_CARD,3174.56
CREDIT,8/30/2019,CVO HOLDING COMP DIRECT DEP                 PPD ID: 9111111101,1388.35,ACH_CREDIT,3190.72
DEBIT,8/29/2019,TARGET        00032615 PHOENIX AZ            08/28,-12.26,DEBIT_CARD,1802.37
DEBIT,8/29/2019,SQ *CARTEL COFFEE LAB Phoenix AZ             08/28,-4.75,DEBIT_CARD,1814.63
DEBIT,8/28/2019,STAPLES       00102632 PHOENIX AZ            08/27,-1.09,DEBIT_CARD,1819.38
DEBIT,8/28/2019,CVS/PHARMACY #08366 PHOENIX AZ               08/27,-5.99,DEBIT_CARD,1820.47
DEBIT,8/28/2019,GCU STUDENT UNION PHOENIX AZ                 08/27,-7.69,DEBIT_CARD,1826.46
DEBIT,8/28/2019,GCU STUDENT UNION PHOENIX AZ                 08/27,-2.44,DEBIT_CARD,1834.15
DEBIT,8/27/2019,SCRAMBLE A BREAKFAST JO PHOENIX AZ           08/25,-35.41,DEBIT_CARD,1836.59
DEBIT,8/26/2019,CENTRAL KITCHEN PHOENIX AZ                   08/25,-30.25,DEBIT_CARD,1872
DEBIT,8/26/2019,SORSO WINE ROOM SCOTTSDALE AZ                08/24,-22.37,DEBIT_CARD,1902.25
DEBIT,8/26/2019,STARBUCKS STORE 05865 PHOENIX AZ             08/24,-2.66,DEBIT_CARD,1924.62
DEBIT,8/26/2019,SQ *PRESS SCOTTSDALE QU Phoenix AZ           08/24,-9.56,DEBIT_CARD,1927.28
DEBIT,8/26/2019,CVS/PHARMACY #08366 PHOENIX AZ               08/24,-27.05,DEBIT_CARD,1936.84
DEBIT,8/26/2019,SPORT CLIPS - AZ141 - P PHOENIX AZ           08/23,-25,DEBIT_CARD,1963.89
DEBIT,8/26/2019,SPECTRUM DERMATOLOGY SCOTTSDALE AZ           08/22,-30,DEBIT_CARD,1988.89
DEBIT,8/23/2019,QUIKTRIP PHOENIX AZ                  009315  08/23,-46.77,DEBIT_CARD,2018.89
DEBIT,8/23/2019,CVS/PHARMACY #08366 PHOENIX AZ               08/22,-19.32,DEBIT_CARD,2065.66
DEBIT,8/23/2019,TRADER JOE'S #090  QPS PHOENIX AZ            08/22,-22.94,DEBIT_CARD,2084.98
DEBIT,8/22/2019,APS electric pmt PAYMENT    3518057919      WEB ID: 1860011170,-208.41,ACH_DEBIT,2107.92
DEBIT,8/22/2019,CHICK-FIL-A #03191 PHOENIX AZ                08/20,-8.24,DEBIT_CARD,2316.33
DEBIT,8/21/2019,USCONNECT ACEVN VEND  N TEMPE AZ             08/21,-1,DEBIT_CARD,2324.57
DEBIT,8/20/2019,FRY'S FOOD DRG 129 PHOENIX AZ                08/19,-30.53,DEBIT_CARD,2325.57
DEBIT,8/20/2019,CVS/PHARMACY #08914 PHOENIX AZ               08/19,-7.88,DEBIT_CARD,2356.1
CREDIT,8/20/2019,VENMO            CASHOUT                    PPD ID: 5264681992,100,ACH_CREDIT,2363.98
DEBIT,8/19/2019,LORENZO'S PIZZA SCOTTSDALE AZ                08/18,-44.26,DEBIT_CARD,2263.98
DEBIT,8/19/2019,PP*GRAYHAWKSCO SCOTTSDALE AZ                 08/18,-3.35,DEBIT_CARD,2308.24
DEBIT,8/19/2019,TEAMTREEHOUSE.COM 800-928-2130 FL            08/18,-25,DEBIT_CARD,2311.59
DEBIT,8/19/2019,USCONNECT ACEVN VEND  N TEMPE AZ             08/18,-1,DEBIT_CARD,2336.59
DEBIT,8/19/2019,CHICK-FIL-A #03191 PHOENIX AZ                08/17,-8.24,DEBIT_CARD,2337.59
DEBIT,8/19/2019,CHEVRON 0213231 PHOENIX AZ                   08/17,-32.7,DEBIT_CARD,2345.83
DEBIT,8/19/2019,CULINARY DROPOUT PHOENIX AZ                  08/16,-24.63,DEBIT_CARD,2378.53
DEBIT,8/19/2019,THE ORVIS CO #699 PHOENIX AZ                 08/16,-55.7,DEBIT_CARD,2403.16
DEBIT,8/16/2019,VZWRLSS*BILL PAY VN 800-922-0204 FL          08/16,-132.03,DEBIT_CARD,2458.86
DEBIT,8/16/2019,DISCOVER         E-PAYMENT  2463            WEB ID: 2510020270,-843.61,ACH_DEBIT,2590.89
DEBIT,8/16/2019,PERMIT/CITATION PRKGS 805-562-8200 CA        08/15,-150,DEBIT_CARD,3434.5
DEBIT,8/16/2019,FRY'S FOOD DRG 129 PHOENIX AZ                08/15,-55.38,DEBIT_CARD,3584.5
CREDIT,8/16/2019,CVO HOLDING COMP DIRECT DEP                 PPD ID: 9111111101,1388.33,ACH_CREDIT,3639.88
DEBIT,8/15/2019,Online Payment 8540305739 To Auto Loan 5817 08/15,-233,LOAN_PMT,2251.55
DEBIT,8/15/2019,SHELL OIL 57442596607 HEBER AZ               08/14,-3.58,DEBIT_CARD,2484.55
DEBIT,8/15/2019,LOVE S COUNTRY00002105 ALBUQUERQUE NM        08/14,-2.09,DEBIT_CARD,2488.13
DEBIT,8/15/2019,SHELL OIL 57442462909 CASTLE ROCK CO         08/14,-7.12,DEBIT_CARD,2490.22
DEBIT,8/15/2019,LOAF N JUG #0048 FRISCO CO                   08/14,-35.46,DEBIT_CARD,2497.34
DEBIT,8/15/2019,LOS AMIGOS - VAIL VAIL CO                    08/13,-24,DEBIT_CARD,2532.8
CREDIT,8/15/2019,ATM CASH DEPOSIT 08/15 5041 N 16TH ST PHOENIX AZ,550,ATM,2556.8
DEBIT,8/14/2019,SHELL SERVICE S TRINIDAD CO                  08/14,-2.33,DEBIT_CARD,2006.8
DEBIT,8/14/2019,7-ELEVEN DENVER CO                           08/14,-9.56,DEBIT_CARD,2009.13
DEBIT,8/14/2019,7-ELEVEN DENVER CO                           08/14,-1.97,DEBIT_CARD,2018.69
DEBIT,8/14/2019,VAIL VALLEY ANGLERS EDWARDS CO               08/13,-105.86,DEBIT_CARD,2020.66
DEBIT,8/14/2019,VENDETTA'S RESTAURANT 970-4765070 CO         08/12,-23.5,DEBIT_CARD,2126.52
DEBIT,8/13/2019,SQ *BIG BEAR BISTRO Vail CO                  08/12,-5.88,DEBIT_CARD,2150.02
DEBIT,8/12/2019,THE MARKET AT V VAIL CO                      08/11,-24.54,DEBIT_CARD,2155.9
DEBIT,8/12/2019,VAIL VALLEY ANGLERS EDWARDS CO               08/11,-53.11,DEBIT_CARD,2180.44
DEBIT,8/12/2019,RAOCOPARKS&WILDLIFE CO DENVER CO TX          08/11,-41.75,DEBIT_CARD,2233.55
DEBIT,8/12/2019,CIRCLE K # 44138 PUEBLO CO                   08/09,-30.37,DEBIT_CARD,2275.3
DEBIT,8/12/2019,ALON 7-ELEVEN 1739 ALBUQUERQUE NM            08/09,-15.88,DEBIT_CARD,2305.67
DEBIT,8/12/2019,KT VAL GAS STATION PHOENIX AZ                08/08,-22.02,DEBIT_CARD,2321.55
CREDIT,8/12/2019,Online Transfer 8517860323 from Fifth Third Checking ######0462 transaction #: 8517860323 08/12,400,ACCT_XFER,2343.57
DEBIT,8/9/2019,SEI 23172 DENVER CO                          08/09,-3,DEBIT_CARD,1943.57
DEBIT,8/9/2019,LJM TRAVEL CENTE WAGON MOUND NM              08/09,-6.43,DEBIT_CARD,1946.57
DEBIT,8/9/2019,CIRCLE K 05030 FOUNTAIN HILL AZ              08/08,-4.44,DEBIT_CARD,1953
DEBIT,8/8/2019,TARGET        00032615 PHOENIX AZ            08/07,-11.48,DEBIT_CARD,1957.44
DEBIT,8/8/2019,CVS/PHARMACY #08914 PHOENIX AZ               08/07,-4.49,DEBIT_CARD,1968.92
DEBIT,8/8/2019,TATUM INTERNAL MEDICIN 602-4825444 AZ        08/06,-15,DEBIT_CARD,1973.41
DEBIT,8/8/2019,SPECTRUM DERMATOLOGY 000-0000000 AZ          08/06,-30,DEBIT_CARD,1988.41
DEBIT,8/7/2019,CAMELBACK VW MAZDA SUB PHOENIX AZ            08/07,-143.19,DEBIT_CARD,2018.41
DEBIT,8/7/2019,TST* SIP COFFEE & BEER PHOENIX AZ            08/06,-4.89,DEBIT_CARD,2161.6
DEBIT,8/6/2019,SANTAN BREWING CO PHOEN PHOENIX AZ           08/05,-29.44,DEBIT_CARD,2166.49
DEBIT,8/5/2019,The Trend at 51  Rent       98966600        WEB ID: 1861072180,-1195.5,ACH_DEBIT,2195.93
DEBIT,8/5/2019,FRYS FOOD DRG 129 PHOENIX AZ         926690  08/04,-55.89,DEBIT_CARD,3391.43
DEBIT,8/5/2019,CULINARY DROPOUT PHOENIX AZ                  08/03,-26.4,DEBIT_CARD,3447.32
DEBIT,8/5/2019,FRYS FOOD DRG 129 PHOENIX AZ         707317  08/03,-0.99,DEBIT_CARD,3473.72
DEBIT,8/5/2019,ELLY S BRUNCH & CAFE PH PHOENIX AZ           08/03,-29.27,DEBIT_CARD,3474.71
DEBIT,8/5/2019,TST* ZOOKZ - E CAMELBAC PHOENIX AZ           08/03,-14.27,DEBIT_CARD,3503.98
DEBIT,8/5/2019,LUCI'SHEALTHYMARKETPLAC PHOENIX AZ           08/03,-12.31,DEBIT_CARD,3518.25
DEBIT,8/2/2019,MACY'S      451 2410 BILTMORE FASH AZ014885  08/02,-54.3,DEBIT_CARD,3530.56
CREDIT,8/2/2019,VENMO            CASHOUT                    PPD ID: 5264681992,590,ACH_CREDIT,3584.86
CREDIT,8/2/2019,CVO HOLDING COMP DIRECT DEP                 PPD ID: 9111111101,1388.34,ACH_CREDIT,2994.86
DEBIT,8/1/2019,VENMO            PAYMENT    2325681921      WEB ID: 3264681992,-5,ACH_DEBIT,1606.52
DEBIT,8/1/2019,CULINARY DROPOUT PHOENIX AZ                  07/31,-30.79,DEBIT_CARD,1611.52
DEBIT,8/1/2019,CVS/PHARMACY #08914 PHOENIX AZ               07/31,-2.89,DEBIT_CARD,1642.31
DEBIT,8/1/2019,STARBUCKS STORE 06954 PHOENIX AZ             07/31,-3.2,DEBIT_CARD,1645.2
DEBIT,7/30/2019,WHOLEFDS CMA #10476 PHOENIX AZ               07/29,-14.28,DEBIT_CARD,1648.4
DEBIT,7/30/2019,CVS/PHARMACY #08914 PHOENIX AZ               07/29,-5.88,DEBIT_CARD,1662.68
DEBIT,7/29/2019,EXXONMOBIL    99583809 PHOENIX AZ            07/28,-42.56,DEBIT_CARD,1668.56
DEBIT,7/29/2019,TARGET        00032615 PHOENIX AZ            07/28,-3.98,DEBIT_CARD,1711.12
DEBIT,7/26/2019,VENMO            PAYMENT    2302338752      WEB ID: 3264681992,-20,ACH_DEBIT,1715.1
DEBIT,7/25/2019,Online Payment 8467858263 To Auto Loan 5817 07/25,-200,LOAN_PMT,1735.1
CREDIT,7/25/2019,Online Transfer 8459851474 from Fifth Third Checking ######0462 transaction #: 8459851474 07/25,200,ACCT_XFER,1935.1
DEBIT,7/24/2019,APS electric pmt PAYMENT    3518057919      WEB ID: 1860011170,-207.41,ACH_DEBIT,1735.1
DEBIT,7/23/2019,A. WILLIAM CHOULES DDS PHOENIX AZ            07/22,-25,DEBIT_CARD,1942.51
CREDIT,7/23/2019,VENMO            CASHOUT                    PPD ID: 5264681992,80,ACH_CREDIT,1967.51
CREDIT,7/19/2019,CVO HOLDING COMP DIRECT DEP                 PPD ID: 9111111101,1388.33,ACH_CREDIT,1887.51
DEBIT,7/17/2019,SPROUTS FARMERS MAR PHOENIX AZ               07/15,-11.64,DEBIT_CARD,499.18
DEBIT,7/17/2019,LUCI'SHEALTHYMARKETPLAC PHOENIX AZ           07/16,-3.97,DEBIT_CARD,510.82
DEBIT,7/16/2019,CVS/PHARMACY #08914 PHOENIX AZ               07/15,-1.89,DEBIT_CARD,514.79
DEBIT,7/16/2019,SPOONZ CAFE PHOENIX AZ                       07/15,-3.53,DEBIT_CARD,516.68
DEBIT,7/15/2019,ELLY S BRUNCH & CAFE PH PHOENIX AZ           07/14,-26.72,DEBIT_CARD,520.21
CREDIT,7/12/2019,Online Transfer 8418320781 from PNC Savings ######6191 transaction #: 8418320781 07/12,500,ACCT_XFER,546.93
DEBIT,7/11/2019,FRY'S FOOD DRG 129 PHOENIX AZ                07/10,-20.46,DEBIT_CARD,46.93
DEBIT,7/8/2019,Online Payment 8411226664 To Auto Loan 5817 07/08,-432.61,LOAN_PMT,67.39
CREDIT,7/8/2019,Online Transfer 8396747710 from Fifth Third Checking ######0462 transaction #: 8396747710 07/08,500,ACCT_XFER,500
